Easydoor testing
An Interactive Fiction by Dan Bowen
Release 1 / Serial number 201109 / Inform 7 build 6M62 (I6/v6.34 lib 6/12N) SD

Example Location

>e
Side room
You can see a shiny hatch here.

>enter the hatch
You open the shiny hatch.

Front room
You can see a green door here.

>e
You open the green door.

Side room
You can see a shiny hatch here.

>w
Example Location

>n
Front room
You can see a green door here.

>enter door
Side room
You can see a shiny hatch here.

>enter door
Front room
You can see a green door here.

>e
Example Location

* * *

Easydoor testing
An Interactive Fiction by Dan Bowen
Release 1 / Serial number 201109 / Inform 7 build 6M62 (I6/v6.34 lib 6/12N) SD

Example Location

>n
Front room
You can see a green door here.

>e
You open the green door.

Side room

>enter door
You open the green door.

Side room

* * *

>e
You open the green door.

Side room

>w
Example Location

* * *

>n
Front room
You can see a green door here.

>e
Side room

>w
Example Location

* * *

>n
Front room
You can see a green door here.

>e
Example Location

>n
Front room
You can see a green door here.

* * *

>e
Example Location

>e
Side room

* * *

>w
Example Location

>enter door
You can't see any such thing.

* * *

>n
Front room
You can see a green door here.

>enter green door
You open the green door.

Side room

>w
Example Location

* * *

>n
Front room
You can see a green door here.

>enter green door
Side room

>w
Example Location

* * *

>n
Front room
You can see a green door here.

>enter green door
Example Location

* * *

>n
Front room
You can see a green door here.

>look
fron room

>e
You can't go that way.

>enter green door
You can't see any such thing.

* * *

Easydoor testing
An Interactive Fiction by Dan Bowen
Release 1 / Serial number 201109 / Inform 7 build 6M62 (I6/v6.34 lib 6/12N) SD

Example Location

>s
You can't go that way.

>w
You can't go that way.

* * *

Easydoor testing
An Interactive Fiction by Dan Bowen
Release 1 / Serial number 201109 / Inform 7 build 6M62 (I6/v6.34 lib 6/12N) SD

Example Location

>w
You can't go that way.

>e
Side room

* * *

>w
Example Location

>s
You can't go that way.