You are in a house in the countryside.  You are into electronics, and it is night time.

Rogers Rd
An Interactive Fiction by Dan Bowen, Version 1.1beta
Release 1 / Serial number 201108 / Inform 7 build 6M62 (I6/v6.34 lib 6/12N) SD

Front Porch
You can see a front door here.

You can go north and south through the front door (closed) from here.

I beg your pardon?

* * *

You are in a house in the countryside.  You are into electronics, and it is night time.

Rogers Rd
An Interactive Fiction by Dan Bowen, Version 1.1beta
Release 1 / Serial number 201108 / Inform 7 build 6M62 (I6/v6.34 lib 6/12N) SD

Front Porch
You can see a front door here.

You can go north and south through the front door (closed) from here.

>dw
That's not a verb I recognise.

>sw
Hallway
Off the hallway are three bedrooms and a bathroom.  The foyer lays to the south.

>e
Michael's room
You can see an air filter here.

>get all
(the air filter)
Taken.

* * *

You are in a house in the countryside.  You are into electronics, and it is night time.

Rogers Rd
An Interactive Fiction by Dan Bowen, Version 1.1beta
Release 1 / Serial number 201108 / Inform 7 build 6M62 (I6/v6.34 lib 6/12N) SD

Front Porch
You can see a front door here.

You can go north and south through the front door (closed) from here.

>examine book
The book has the title "Satellite Frequencies."

* * *

You are in a house in the countryside.  You are into electronics, and it is night time.

Rogers Rd
An Interactive Fiction by Dan Bowen, Version 1.1beta
Release 1 / Serial number 201108 / Inform 7 build 6M62 (I6/v6.34 lib 6/12N) SD

Front Porch
You can see a front door here.

You can go north and south through the front door (closed) from here.

>examine shelf
You can't see any such thing.

>look at shelf
You can't see any such thing.

>get book
You can't see any such thing.

>look
Danny's Bedroom
A brown shelf is in the corner.

You can go southeast from here.

* * *

You are in a house in the countryside.  You are into electronics, and it is night time.

Rogers Rd
An Interactive Fiction by Dan Bowen, Version 1.1beta
Release 1 / Serial number 201108 / Inform 7 build 6M62 (I6/v6.34 lib 6/12N) SD

Front Porch
You can see a front door here.

You can go north and south through the front door (closed) from here.

>get book
[Your score has just gone up by ten points.]

>get book
You already have that.

>drop book
Dropped.

>get book
Taken.

* * *

>get book
[Your score has just gone up by ten points.]

>restart
Are you sure you want to restart?

>y
Rogers Rd
An Interactive Fiction by Dan Bowen
Release 1 / Serial number 201107 / Inform 7 build 6M62 (I6/v6.34 lib 6/12N) SD

Danny's Bedroom
You can see a shelf (on which is a brown book) here.

You can go southeast from here.

>get book
Taken.

* * *

>y
Rogers Rd
An Interactive Fiction by Dan Bowen
Release 1 / Serial number 201107 / Inform 7 build 6M62 (I6/v6.34 lib 6/12N) SD

Danny's Bedroom
You can see a shelf (on which is a brown book) here.

You can go southeast from here.

>se
Hallway
Off the hallway are three bedrooms and a bathroom.  The foyer lays to the south.

You can go north, northwest to Danny's Bedroom, south, southwest and east from here.

>e
Foyer
A linoluem floor looks out the front door to the north.

You can see a front door and an Ironing Board (on which is a can of starch) here.

You can go north through the front door (closed), south, east and west to the Hallway from here.

>s
dining room
You can go north to the Foyer, south and east from here.

>e
kitchen
You can go south, east and west to the dining room from here.

>e
back hallway
You can see a garage door and a cellar stairs here.

You can go north through the garage door (closed), south, east, west to the kitchen and down through the cellar stairs (closed) from here.

>e
ham shack
You can see a ham shack door, a heavy UHF radio and a teletype here.

You can go east through the ham shack door (closed) and west to the back hallway from here.

>turn radio on
The radio dial lights up. Static crackles.
you don't know any interesting frequencies to listen to, so you shut the radio back off.

* * *

>get book
[Your score has just gone up by ten points.]

>se
Hallway
Off the hallway are three bedrooms and a bathroom.  The foyer lays to the south.

You can go north, northwest to Danny's Bedroom, south, southwest and east from here.

* * *

>s
dining room
You can go north to the Foyer, south and east from here.

>ee
That's not a verb I recognise.

>e
kitchen
You can go south, east and west to the dining room from here.

* * *

>e
ham shack
You can see a ham shack door, a heavy UHF radio and a teletype here.

You can go east through the ham shack door (closed) and west to the back hallway from here.

>turn radio on
you have frequencies.

* * *

You are in a house in the countryside.  You are into electronics, and it is night time.

Rogers Rd
An Interactive Fiction by Dan Bowen, Version 1.1beta
Release 1 / Serial number 201108 / Inform 7 build 6M62 (I6/v6.34 lib 6/12N) SD

Front Porch
You can see a front door here.

You can go north and south through the front door (closed) from here.

>look
Front Porch
You can see a front door here.

You can go north and south through the front door (closed) from here.

>e
You can't go that way.

>n
front yard
In the sky you notice a bright point of light creeping overhead.

You can go south to the Front Porch and east from here.

>x sky
There is a bright satellite passing overhead.

* * *

>look
Front Porch
You can see a front door here.

You can go north and south through the front door (closed) from here.

>n
front yard
In the sky you notice a bright point of light creeping overhead.

You can go south to the Front Porch and east from here.

>look at sky
There is a bright point of light creeping across the sky.

>examine sky
There is a bright point of light creeping across the sky.

>e
driveway
The gravelly pavement seems gray and boring.

You can go south, southeast and west to the front yard from here.

>look
driveway
The gravelly pavement seems gray and boring.

You can go south, southeast and west to the front yard from here.

>examine sky
There is a bright point of light creeping across the sky.

* * *

You are in a house in the countryside.  You are into electronics, and it is night time.

Rogers Rd
An Interactive Fiction by Dan Bowen, Version 1.1beta
Release 1 / Serial number 201108 / Inform 7 build 6M62 (I6/v6.34 lib 6/12N) SD

Front Porch
You can see a front door here.

You can go north and south through the front door (closed) from here.

>look at shelf
You can't see any such thing.

>examine shelf
You can't see any such thing.

>open shelf
You can't see any such thing.

* * *

You are in a house in the countryside.  You are into electronics, and it is night time.

Rogers Rd
An Interactive Fiction by Dan Bowen, Version 1.1beta
Release 1 / Serial number 201108 / Inform 7 build 6M62 (I6/v6.34 lib 6/12N) SD

Front Porch
You can see a front door here.

You can go north and south through the front door (closed) from here.

>n
front yard
In the sky you notice a bright point of light creeping overhead.

You can go south to the Front Porch and east from here.

>e
driveway
The gravelly pavement seems gray and boring.

You can go south, southeast and west to the front yard from here.

>examine sky
You can't see any such thing.

>look
driveway
The gravelly pavement seems gray and boring.

You can go south, southeast and west to the front yard from here.

* * *

>e
driveway
The gravelly pavement seems gray and boring.

You can go south, southeast and west to the front yard from here.

>se
side yard
You can see a side yard shack door here.

You can go northwest to the driveway, southwest and west through the side yard shack door (closed) from here.

>sw
back yard hill
You can see an antenna here.

You can go north, northeast to the side yard and south from here.

>examine antenna
The antenna pole is tall, and has a satellite dish on top.  The disk is slowly tracking a bright spot in the sky.

>s
middle back yard
You can see a sky (in which is a satellite) here.

You can go north to the back yard hill from here.

>n
back yard hill
You can see an antenna here.

You can go north, northeast to the side yard and south to the middle back yard from here.

>n
back porch
You can see a back door here.

You can go north through the back door (closed) and south to the back yard hill from here.

>n
(first opening the back door)

back hallway
You can see a back door, a cellar stairs and a garage door here.

You can go north through the garage door (closed), south through the back door to the back porch, east, west and down through the cellar stairs (closed) from here.

>d
(first opening the cellar stairs)

cellar
You can see a cellar stairs here.

You can go north, west and up through the cellar stairs to the back hallway from here.

>n
radiostation
A suite of electronics is jammed into the small room. There is nothing to do here, it appears fully automated.

You can go south to the cellar from here.

>s
cellar
You can see a cellar stairs here.

You can go north to the radiostation, west and up through the cellar stairs to the back hallway from here.

>w
Furnace room
You can go east to the cellar from here.

>e
cellar
You can see a cellar stairs here.

You can go north to the radiostation, west to the Furnace room and up through the cellar stairs to the back hallway from here.

>s
You can't go that way.

>u
back hallway
You can see a cellar stairs, a back door and a garage door here.

You can go north through the garage door (closed), south through the back door to the back porch, east, west and down through the cellar stairs to the cellar from here.

* * *

You are in a house in the countryside.  You are into electronics, and it is night time.

Rogers Rd
An Interactive Fiction by Dan Bowen, Version 1.1beta
Release 1 / Serial number 201108 / Inform 7 build 6M62 (I6/v6.34 lib 6/12N) SD

Front Porch
You can see a front door here.

You can go north and south through the front door (closed) from here.

>s
(first opening the front door)

Foyer
Lined with a linoluem floor.

You can see a front door and an Ironing Board (on which is a can of starch) here.

You can go north through the front door to the Front Porch, south, east and west from here.

>e
living room
You can see a shelf (on which is a brown book) here.

You can go west to the Foyer from here.

>get
(the shelf)
That's fixed in place.

>get book
[Your score has just gone up by ten points.]

>w
Foyer
Lined with a linoluem floor.

You can see a front door and an Ironing Board (on which is a can of starch) here.

You can go north through the front door to the Front Porch, south, east to the living room and west from here.

>s
dining room
This room has a green rug.

You can go north to the Foyer, south and east from here.

>e
kitchen
You can see a phone (on which is a note) here.

You can go south, east and west to the dining room from here.

>e
back hallway
a dark and dingy place.

You can see a back door, a cellar stairs and a garage door here.

You can go north through the garage door (closed), south through the back door (closed), east, west to the kitchen and down through the cellar stairs (closed) from here.

>e
ham shack
smelling of solder and machine oil.

You can see a side yard shack door, a heavy UHF radio and a teletype here.

You can go east through the side yard shack door (closed) and west to the back hallway from here.

>turn radio on
The radio dial lights up. Static crackles.
You have the satellite frequency book, and you're bored, so you set the radio to the frequency of Radstar-1.  The radio warbles, and the teletype begins clanking and hammering out a message. 

Please press SPACE to continue.

DOWNLINK MESSAGE:

I am a HAL 9000 satellite. I became operational at the H.A.L. Plant in Urbana, Illinois, on the 12th of January, 1992.

All buildings are to be irradiated from space by Vogon Pest Control at 11:00PM.  Humans are advised to be below ground level to avoid certain doom.

[Your score has just gone up by ten points.]

>w
back hallway
a dark and dingy place.

You can see a back door, a cellar stairs and a garage door here.

You can go north through the garage door (closed), south through the back door (closed), east to the ham shack, west to the kitchen and down through the cellar stairs (closed) from here.

>s
(first opening the back door)

back porch
You can see a back door here.

You can go north through the back door to the back hallway and south from here.

>d
You can't go that way.

>z
Time passes.

>z
Time passes.

>z
Time passes.

At the stroke of 11, radiation beams sweep across the land, penetrating buildings and open spaces alike.

    *** You are hardly aware as you are zapped into oblivion by the Vogon Pest Control Beam.

You have died. ***

In that game you scored 20 out of a possible 40, in 61 turns, earning you the rank of interesting person.

Would you like to RESTART, RESTORE a saved game, QUIT or UNDO the last command?

>undo
back porch
[Previous turn undone.]

>undo
back porch
[Previous turn undone.]

>n
back hallway
a dark and dingy place.

You can see a back door, a cellar stairs and a garage door here.

You can go north through the garage door (closed), south through the back door to the back porch, east to the ham shack, west to the kitchen and down through the cellar stairs (closed) from here.

>d
(first opening the cellar stairs)

cellar
You can see a cellar stairs here.

You can go north, west and up through the cellar stairs to the back hallway from here.

At the stroke of 11, radiation beams sweep across the land, penetrating buildings and open spaces alike.You hear a zapping noise from the house above.  The radiation is shielded from you by the ground around the cellar.

You have survived!

[Your score has just gone up by twenty points.]

* * *

>e
living room
You can see a shelf (on which is a brown book) here.

You can go west to the Foyer from here.

>get all
brown book: [Your score has just gone up by ten points.]

>w
Foyer
Lined with a linoluem floor.

You can see a front door and an Ironing Board (on which is a can of starch) here.

You can go north through the front door to the Front Porch, south, east to the living room and west from here.

* * *

>turn radio on
The radio dial lights up. Static crackles.
You have the satellite frequency book, and you're bored, so you set the radio to the frequency of Radstar-1.  The radio warbles, and the teletype begins clanking and hammering out a message. 

Please press SPACE to continue.

DOWNLINK MESSAGE:

I am a HAL 9000 satellite. I became operational at the H.A.L. Plant in Urbana, Illinois, on the 12th of January, 1992.

Please press SPACE to continue.

* * *

All buildings are to be irradiated from space by Vogon Pest Control at 11:30PM.  Humans are advised to be below ground level to avoid certain doom.

[Your score has just gone up by ten points.]

* * *

>s
(first opening the front door)

Foyer
Lined with a linoluem floor.

You can see a front door and an Ironing Board (on which is a can of starch) here.

You can go north through the front door to the Front Porch, south, east and west from here.

>n
Porch
You can see a front door here.

You can go north and south through the front door to the Foyer from here.

>test me
(Testing.)

>[1] s

Foyer
A linoluem floor looks out the front door to the north.

You can see a front door and an Ironing Board (on which is a can of starch) here.

You can go north through the front door to the Porch, south, east and west from here.

>[2] e

living room
You can see a shelf (on which is a brown book) here.

You can go west to the Foyer from here.

>[3] get book
[Your score has just gone up by ten points.]

>[4] w

Foyer
A linoluem floor looks out the front door to the north.

You can see a front door and an Ironing Board (on which is a can of starch) here.

You can go north through the front door to the Porch, south, east to the living room and west from here.

>[5] s

dining room
You can go north to the Foyer, south and east from here.

>[6] e

kitchen
You can see a phone (on which is a note) here.

You can go south, east and west to the dining room from here.

>[7] e

back hallway
You can see a back door, a cellar stairs and a garage door here.

You can go north through the garage door (closed), south through the back door (closed), east, west to the kitchen and down through the cellar stairs (closed) from here.

>[8] e

ham shack
You can see a side yard shack door, a heavy UHF radio and a teletype here.

You can go east through the side yard shack door (closed) and west to the back hallway from here.

>[9] turn radio on
The radio dial lights up. Static crackles.
You have the satellite frequency book, and you're bored, so you set the radio to the frequency of Radstar-1.  The radio warbles, and the teletype begins clanking and hammering out a message.  The message says "I am a HAL 9000 satellite. I became operational at the H.A.L. Plant in Urbana, Illinois, on the 12th of January, 1992."

    *** THE END. You have been amused by a satellite.  Good job! ***

In that game you scored 20 out of a possible 0, in 11 turns.

Would you like to RESTART, RESTORE a saved game, QUIT or UNDO the last command?

* * *

>s
(first opening the front door)

Foyer
Lined with a linoluem floor.

You can see a front door and an Ironing Board (on which is a can of starch) here.

You can go north through the front door to the Front Porch, south, east and west from here.

>s
dining room
This room has a green rug.

You can go north to the Foyer, south and east from here.

* * *

>e
back hallway
a dark and dingy place.

You can see a back door, a cellar stairs and a garage door here.

You can go north through the garage door (closed), south through the back door (closed), east, west to the kitchen and down through the cellar stairs (closed) from here.

>d
(first opening the cellar stairs)

cellar
You can see a cellar stairs here.

You can go north, west and up through the cellar stairs to the back hallway from here.

>w
Furnace room
You can go east to the cellar from here.

Radiation beams sweep across the land, penetrating buildings and open spaces alike.
You hear a zapping noise from the house above.  The radiation is shielded from you by the ground around the cellar.

You have survived!

[Your score has just gone up by twenty points.]

* * *

>d
(first opening the cellar stairs)

cellar
You can see a cellar stairs here.

You can go north, west and up through the cellar stairs to the back hallway from here.

>z
Time passes.

At the stroke of 11:00, radiation beams sweep across the land, penetrating buildings and open spaces alike.
You hear a zapping noise from the house above.  The ground around the cellar has blocked the radiation beams from burninating you.

You have survived!

    *** The End ***

In that game you scored 20 out of a possible 40, in 6 turns, earning you the rank of interesting person.

Would you like to RESTART, RESTORE a saved game, QUIT or UNDO the last command?

* * *

>e
back hallway
a dark and dingy place.

You can see a back door, a cellar stairs and a garage door here.

You can go north through the garage door (closed), south through the back door (closed), east, west to the kitchen and down through the cellar stairs (closed) from here.

>s
(first opening the back door)

back porch
You can see a back door here.

You can go north through the back door to the back hallway and south from here.

>s
back yard hill
You can see an antenna pole (on which is a dish) here.

You can go north to the back porch, northeast and south from here.

* * *

>s
dining room
This room has a green rug.

You can go north to the Foyer, south and east from here.

>s
New room west
this room is big.

You can go north to the dining room and east from here.

>s
You can't go that way.

>s
You can't go that way.

>s
You can't go that way.

At the stroke of 11:00, radiation beams sweep across the land, penetrating buildings and open spaces alike.
You are hardly aware as you are zapped into oblivion by the Vogon Pest Control Beam. end the story finally saying

You have died.

    *** The End ***

In that game you scored 0 out of a possible 40, in 6 turns, earning you the rank of Boring person.

Would you like to RESTART, RESTORE a saved game, QUIT or UNDO the last command?

>s
Please give one of the answers above.

Would you like to RESTART, RESTORE a saved game, QUIT or UNDO the last command?

>restart
You are in a house in the countryside.  You are into electronics, and it is night time.

Rogers Rd
An Interactive Fiction by Dan Bowen
Release 1 / Serial number 201108 / Inform 7 build 6M62 (I6/v6.34 lib 6/12N) SD

Front Porch
You can see a front door here.

You can go north and south through the front door (closed) from here.

>s
(first opening the front door)

Foyer
Lined with a linoluem floor.

You can see a front door and an Ironing Board (on which is a can of starch) here.

You can go north through the front door to the Front Porch, south, east and west from here.

>w
Hallway
You can go north, northwest, south, southwest and east to the Foyer from here.

>w
You can't go that way.

>nw
Danny's Bedroom
You can see a dot matrix printout here.

You can go southeast to the Hallway from here.

>get printout
Taken.

>read printout
This appears to be a list of satellite orbits,  showing the times that a satellite RDS-1 passes over this location.  Tonight's date is in the list.

>se
Hallway
You can go north, northwest to Danny's Bedroom, south, southwest and east to the Foyer from here.

>e
Foyer
Lined with a linoluem floor.

You can see a front door and an Ironing Board (on which is a can of starch) here.

You can go north through the front door to the Front Porch, south, east and west to the Hallway from here.

>e
living room
You can see a shelf (on which is a brown book) here.

You can go west to the Foyer from here.

>examine book
The book has the title "Satellite Frequencies."

>get book
[Your score has just gone up by ten points.]

>w
Foyer
Lined with a linoluem floor.

You can see a front door and an Ironing Board (on which is a can of starch) here.

You can go north through the front door to the Front Porch, south, east to the living room and west to the Hallway from here.

>s
dining room
This room has a green rug.

You can go north to the Foyer, south and east from here.

* * *

>s
(first opening the back door)

back porch
You can see a back door here.

You can go north through the back door to the back hallway and south from here.

>s
back yard hill
You can see an antenna here.

You can go north to the back porch, northeast and south from here.

* * *

You are in a house in the countryside.  You are into electronics, and it is night time.

Rogers Rd
An Interactive Fiction by Dan Bowen, Version 1.1beta
Release 1 / Serial number 201108 / Inform 7 build 6M62 (I6/v6.34 lib 6/12N) SD

Front Porch
You can see a front door here.

You can go north and south through the front door (closed) from here.

>se
Hallway
Off the hallway are three bedrooms and a bathroom.  The foyer lays to the south.

You can go north, northwest to Danny's Bedroom, south, southwest and east from here.

>dw
That's not a verb I recognise.

>sw
Dad's room
in the middle of the room is a pink waterbed.

>get waterbet
You can't see any such thing.

>get all
There are none at all available!

>get in waterbed
You get into the waterbed.

>exit
You get out of the waterbed.

Dad's room
in the middle of the room is a pink waterbed.

* * *

>e
Foyer
A linoluem floor looks out the front door to the north.

You can see a front door and an Ironing Board (on which is a can of starch) here.

You can go north through the front door (closed), south, east and west to the Hallway from here.

>examine starch
 test

* * *

>e
Foyer
A linoluem floor looks out the front door to the north.

You can see a front door and an Ironing Board (on which is a can of starch) here.

You can go north through the front door (closed), south, east and west to the Hallway from here.

>get ironing board
That's fixed in place.

>get starch
Taken.

>examine starch
Niagara Starch: Not useful in this game :-)

* * *

>e
Foyer
A linoluem floor looks out the front door to the north.

You can see a front door and an Ironing Board (on which is a can of starch) here.

You can go north through the front door (closed), south, east and west to the Hallway from here.

>look
Foyer
A linoluem floor looks out the front door to the north.

On the Ironing Board is a can of starch.

You can also see a front door here.

You can go north through the front door (closed), south, east and west to the Hallway from here.

* * *

>e
Foyer
A linoluem floor looks out the front door to the north.

You can see a front door and an Ironing Board (on which is a can of starch) here.

You can go north through the front door (closed), south, east and west to the Hallway from here.

>n
(first opening the front door)

porch
You can see a front door here.

You can go north and south through the front door to the Foyer from here.

>SHOWME
porch - room
    yourself - person

* * *

>n
(first opening the front door)

porch
You can see a front door here.

You can go north and south through the front door to the Foyer from here.

>get door
That's fixed in place.

>close door
You close the front door.

>s
(first opening the front door)

Foyer
A linoluem floor looks out the front door to the north.

You can see a front door and an Ironing Board here.

* * *

>n
(first opening the front door)

porch
You can see a front door here.

You can go north and south through the front door to the Foyer from here.

>n
front yard
In the sky you notice a bright satellite creeping overhead.

You can go south to the porch and east from here.

* * *

>e
back hallway
You can see a garage door and a cellar stairs here.

You can go north through the garage door (closed), south, east, west to the kitchen and down through the cellar stairs (closed) from here.

>s
back door
You can go north to the back hallway and south from here.

* * *

>s
dining room
You can go north to the Foyer, south and east from here.

>e
kitchen
You can see a phone (on which is a note) here.

You can go south, east and west to the dining room from here.

>e
back hallway
You can see a back door, a garage door and a cellar stairs here.

You can go north through the garage door (closed), south through the back door (closed), east, west to the kitchen and down through the cellar stairs (closed) from here.

>e
ham shack
You can see a ham shack door, a heavy UHF radio and a teletype here.

You can go east through the ham shack door (closed) and west to the back hallway from here.

>turn radio on
The radio dial lights up. Static crackles.

>restart
Are you sure you want to restart?

* * *

>get book
Taken.

>se
Hallway
Off the hallway are three bedrooms and a bathroom.  The foyer lays to the south.

You can go north, northwest to Danny's Bedroom, south, southwest and east from here.

* * *

>e
Foyer
A linoluem floor looks out the front door to the north.

You can see a front door and an Ironing Board (on which is a can of starch) here.

You can go north through the front door (closed), south, east and west to the Hallway from here.

>e
living room
You can go west to the Foyer from here.

>w
Foyer
A linoluem floor looks out the front door to the north.

You can see a front door and an Ironing Board (on which is a can of starch) here.

You can go north through the front door (closed), south, east to the living room and west to the Hallway from here.

>s
dining room
You can go north to the Foyer, south and east from here.

* * *

>e
ham shack
You can see a ham shack door, a heavy UHF radio and a teletype here.

You can go east through the ham shack door (closed) and west to the back hallway from here.

>turn radio on
The radio dial lights up. Static crackles.
You have frequency book, so you set the radio to the frequency of Radstar-1.  The teletype begins clanking and hammering out a message.  The message says "Vogon construction fleet approaching.  exit all building to prevent death.

[Your score has just gone up by ten points.]

* * *

>turn radio on
The radio dial lights up. Static crackles.

>w
back hallway
You can see a garage door and a cellar stairs here.

You can go north through the garage door (closed), south, east to the ham shack, west to the kitchen and down through the cellar stairs (closed) from here.

>w
kitchen
You can go south, east to the back hallway and west to the dining room from here.

>w
dining room
You can go north to the Foyer, south and east to the kitchen from here.

>w
You can't go that way.

>n
Foyer
A linoluem floor looks out the front door to the north.

You can see a front door and an Ironing Board (on which is a can of starch) here.

You can go north through the front door (closed), south to the dining room, east and west to the Hallway from here.

>w
Hallway
Off the hallway are three bedrooms and a bathroom.  The foyer lays to the south.

You can go north, northwest to Danny's Bedroom, south, southwest and east to the Foyer from here.

>w
You can't go that way.

>n
Michael's room
You can see an air filter here.

You can go south to the Hallway from here.

>s
Hallway
Off the hallway are three bedrooms and a bathroom.  The foyer lays to the south.

You can go north to Michael's room, northwest to Danny's Bedroom, south, southwest and east to the Foyer from here.

>nw
Danny's Bedroom
You can see a shelf (on which is a brown book) here.

You can go southeast to the Hallway from here.

>get book
Taken.

>se
Hallway
Off the hallway are three bedrooms and a bathroom.  The foyer lays to the south.

You can go north to Michael's room, northwest to Danny's Bedroom, south, southwest and east to the Foyer from here.

>e
Foyer
A linoluem floor looks out the front door to the north.

You can see a front door and an Ironing Board (on which is a can of starch) here.

You can go north through the front door (closed), south to the dining room, east and west to the Hallway from here.

>s
dining room
You can go north to the Foyer, south and east to the kitchen from here.

>e
kitchen
You can go south, east to the back hallway and west to the dining room from here.

>e
back hallway
You can see a garage door and a cellar stairs here.

You can go north through the garage door (closed), south, east to the ham shack, west to the kitchen and down through the cellar stairs (closed) from here.

>e
ham shack
You can see a ham shack door, a heavy UHF radio and a teletype here.

You can go east through the ham shack door (closed) and west to the back hallway from here.

>turn radio on
That's already on.

>turn radio off
You switch the heavy UHF radio off.

>turn radio on
The radio dial lights up. Static crackles.
You have the satellite frequency book, and you're bored, so you set the radio to the frequency of Radstar-1.  The teletype begins clanking and hammering out a message.  The message says "Vogon construction fleet approaching.  exit all building to prevent death."

[Your score has just gone up by ten points.]

* * *

>e
back hallway
You can see a back door, a garage door and a cellar stairs here.

You can go north through the garage door (closed), south through the back door (closed), east, west to the kitchen and down through the cellar stairs (closed) from here.

>s
(first opening the back door)

back porch
You can see a back door here.

You can go north through the back door to the back hallway and south from here.

* * *

>s
back yard hill
You can see an antenna here.

You can go north to the back porch, northeast and south from here.

>s
middle back yard
You can go north to the back yard hill from here.

* * *

>e
kitchen
You can see a phone (on which is a note) here.

You can go south, east and west to the dining room from here.

>examine note
Wendell says the satellite will be coming overhead tonight.

>get note
Taken.

>examine note
Wendell says the satellite will be coming overhead tonight.

* * *

>e
kitchen
You can see a phone (on which is a note) here.

You can go south, east and west to the dining room from here.

>look
kitchen
You can go south, east and west to the dining room from here.

* * *

>e
Foyer
A linoluem floor looks out the front door to the north.

You can see a front door and an Ironing Board (on which is a can of starch) here.

You can go north through the front door (closed), south, east and west to the Hallway from here.

>verbose
Rogers Rd is now in its "verbose" mode, which always gives long descriptions of locations (even if you've been there before).

* * *

>se
Hallway
Off the hallway are three bedrooms and a bathroom.  The foyer lays to the south.

You can go north, northwest to Danny's Bedroom, south, southwest and east from here.

>look
Danny's Bedroom
A brown shelf is in the corner.

>sw
Hallway
Off the hallway are three bedrooms and a bathroom.  The foyer lays to the south.

* * *

>se
Hallway
Off the hallway are three bedrooms and a bathroom.  The foyer lays to the south.

You can go north, northwest to Danny's Bedroom, south, southwest and east from here.

>n
Michael's room
You can see an air filter and a heavy UHF radio transceiver here.

You can go south to the Hallway from here.

>examine filter
The filter whooshes quietly, blowing clean air into your eyes.  This is uncomfortable, so you stop doing it.

* * *

>n
Michael's room
You can see an air filter and a heavy UHF radio transceiver here.

You can go south to the Hallway from here.

>get radio
Taken.

>examine radio
The scanner has batteries, but there is no antenna connected.

* * *

>n
Michael's room
You can see an air filter and a heavy UHF radio transceiver here.

You can go south to the Hallway from here.

>look
Michael's room
The scanner has batteries, but there is no antenna connected.

You can also see an air filter here.

You can go south to the Hallway from here.

* * *

>se
Hallway
Off the hallway are three bedrooms and a bathroom.  The foyer lays to the south.

You can go north, northwest to Danny's Bedroom, south, southwest and east from here.

>s
Hall bathroom
You can go north to the Hallway from here.

>n
Hallway
Off the hallway are three bedrooms and a bathroom.  The foyer lays to the south.

You can go north, northwest to Danny's Bedroom, south to the Hall bathroom, southwest and east from here.

>e
Foyer
A linoluem floor looks out the front door to the north.

You can see a front door and an Ironing Board (on which is a can of starch) here.

You can go north through the front door (closed), south, east and west to the Hallway from here.

* * *

>se
Hallway
Off the hallway are three bedrooms and a bathroom.  The foyer lays to the south.

You can go north, northwest to Danny's Bedroom, south, southwest and east from here.

>sw
Dad's room
in the middle of the room is a pink waterbed.

>get in
You get into the waterbed.

>look
Dad's room (in the waterbed)

>examine bed
You can't see any such thing.

>examine waterbed
You slosh around on top of the bed.

>out
You get out of the waterbed.

Dad's room
in the middle of the room is a pink waterbed.

>look
Dad's room
in the middle of the room is a pink waterbed.

>examine waterbed
You slosh around on top of the bed.

* * *

You are in a house in the countryside.  You are into electronics, and it is night time.

Rogers Rd
An Interactive Fiction by Dan Bowen, Version 1.1beta
Release 1 / Serial number 201108 / Inform 7 build 6M62 (I6/v6.34 lib 6/12N) SD

Front Porch
You can see a front door here.

You can go north and south through the front door (closed) from here.

>se e e
I only understood you as far as wanting to (go) se.

>se
Hallway
Off the hallway are three bedrooms and a bathroom.  The foyer lays to the south.

You can go north, northwest to Danny's Bedroom, south, southwest and east from here.

* * *

>e
kitchen
You can go south, east and west to the dining room from here.

>e
back hallway
You can see a back door, a garage door and a cellar stairs here.

You can go north through the garage door (closed), south through the back door (closed), east, west to the kitchen and down through the cellar stairs (closed) from here.

* * *

>s
(first opening the back door)

back porch
You can see a back door here.

You can go north through the back door to the back hallway and south from here.

>s
back yard hill
You can see an antenna here.

You can go north to the back porch and south from here.

* * *

You are in a house in the countryside.  You are into electronics, and it is night time.

Rogers Rd
An Interactive Fiction by Dan Bowen, Version 1.1beta
Release 1 / Serial number 201108 / Inform 7 build 6M62 (I6/v6.34 lib 6/12N) SD

Front Porch
You can see a front door here.

You can go north and south through the front door (closed) from here.

>se, e
Hallway
Off the hallway are three bedrooms and a bathroom.  The foyer lays to the south.

You can go north, northwest to Danny's Bedroom, south, southwest and east from here.

Foyer
A linoluem floor looks out the front door to the north.

You can see a front door and an Ironing Board (on which is a can of starch) here.

You can go north through the front door (closed), south, east and west to the Hallway from here.

>n
(first opening the front door)

porch
You can see a front door here.

You can go north and south through the front door to the Foyer from here.

>n
front yard
Test

You can go south to the porch and east from here.

* * *

You are in a house in the countryside.  You are into electronics, and it is night time.

Rogers Rd
An Interactive Fiction by Dan Bowen, Version 1.1beta
Release 1 / Serial number 201108 / Inform 7 build 6M62 (I6/v6.34 lib 6/12N) SD

Front Porch
You can see a front door here.

You can go north and south through the front door (closed) from here.

>se, e,s,e,e,e,s
Hallway
Off the hallway are three bedrooms and a bathroom.  The foyer lays to the south.

You can go north, northwest to Danny's Bedroom, south, southwest and east from here.

Foyer
A linoluem floor looks out the front door to the north.

You can see a front door and an Ironing Board (on which is a can of starch) here.

You can go north through the front door (closed), south, east and west to the Hallway from here.

dining room
You can go north to the Foyer, south and east from here.

kitchen
You can see a phone (on which is a note) here.

You can go south, east and west to the dining room from here.

back hallway
You can see a back door, a garage door and a cellar stairs here.

You can go north through the garage door (closed), south through the back door (closed), east, west to the kitchen and down through the cellar stairs (closed) from here.

ham shack
You can see a side yard shack door, a heavy UHF radio and a teletype here.

You can go east through the side yard shack door (closed) and west to the back hallway from here.

You can't go that way.

I beg your pardon?

>e
(first opening the side yard shack door)

side yard
You can see a side yard shack door here.

You can go northwest, southwest and west through the side yard shack door to the ham shack from here.

>sw
back yard hill
You can see an antenna here.

You can go north, northeast to the side yard and south from here.

>s
middle back yard
You can see a sky (in which is a satellite) here.

You can go north to the back yard hill from here.

>x satellite
You see nothing special about the satellite.

* * *

You are in a house in the countryside.  You are into electronics, and it is night time.

Rogers Rd
An Interactive Fiction by Dan Bowen, Version 1.1beta
Release 1 / Serial number 201108 / Inform 7 build 6M62 (I6/v6.34 lib 6/12N) SD

Front Porch
You can see a front door here.

You can go north and south through the front door (closed) from here.

>se,e,s,e,e,s
Hallway
Off the hallway are three bedrooms and a bathroom.  The foyer lays to the south.

You can go north, northwest to Danny's Bedroom, south, southwest and east from here.

Foyer
A linoluem floor looks out the front door to the north.

You can see a front door and an Ironing Board (on which is a can of starch) here.

You can go north through the front door (closed), south, east and west to the Hallway from here.

dining room
You can go north to the Foyer, south and east from here.

kitchen
You can see a phone (on which is a note) here.

You can go south, east and west to the dining room from here.

back hallway
You can see a back door, a garage door and a cellar stairs here.

You can go north through the garage door (closed), south through the back door (closed), east, west to the kitchen and down through the cellar stairs (closed) from here.

(first opening the back door)

back porch
You can see a back door here.

You can go north through the back door to the back hallway and south from here.

I beg your pardon?

>s
back yard hill
You can see an antenna here.

You can go north to the back porch, northeast and south from here.

>s
middle back yard
You can see a sky (in which is a satellite) here.

You can go north to the back yard hill from here.

* * *

You are in a house in the countryside.  You are into electronics, and it is night time.

Rogers Rd
An Interactive Fiction by Dan Bowen, Version 1.1beta
Release 1 / Serial number 201108 / Inform 7 build 6M62 (I6/v6.34 lib 6/12N) SD

Front Porch
You can see a front door here.

You can go north and south through the front door (closed) from here.

>sw
You can't go that way.

>e
Michael's room

>w
Hallway
Off the hallway are three bedrooms and a bathroom.  The foyer lays to the south.

>ne
Danny's Bedroom
A brown shelf is in the corner.

* * *

>sw
You can't go that way.

>se
Hallway
Off the hallway are three bedrooms and a bathroom.  The foyer lays to the south.

You can go north, northwest to Danny's Bedroom, south, southwest and east from here.

* * *

>e
ham shack
You can see a ham shack door, a heavy UHF radio and a teletype here.

You can go east through the ham shack door (closed) and west to the back hallway from here.

>turn radio on
go tit

>turn radio off
You switch the heavy UHF radio off.

>actions
Actions listing on.

>turn radio on
[switching on the heavy UHF radio]
You switch the heavy UHF radio on.
[switching on the heavy UHF radio - succeeded]

>get radio
[taking the heavy UHF radio]
Taken.
[taking the heavy UHF radio - succeeded]

* * *

You are in a house in the countryside.  You are into electronics, and it is night time.

Rogers Rd
An Interactive Fiction by Dan Bowen, Version 1.1beta
Release 1 / Serial number 201108 / Inform 7 build 6M62 (I6/v6.34 lib 6/12N) SD

Front Porch
You can see a front door here.

You can go north and south through the front door (closed) from here.

>test me
(Testing.)

>[1] s
(first opening the front door)

Foyer
Lined with a linoluem floor.

You can see a front door and an Ironing Board (on which is a can of starch) here.

You can go north through the front door to the Porch, south, east and west from here.

>[2] e

living room
You can see a shelf (on which is a brown book) here.

You can go west to the Foyer from here.

>[3] get book
[Your score has just gone up by ten points.]

>[4] w

Foyer
Lined with a linoluem floor.

You can see a front door and an Ironing Board (on which is a can of starch) here.

You can go north through the front door to the Porch, south, east to the living room and west from here.

>[5] s

dining room
This room has a green rug.

You can go north to the Foyer, south and east from here.

>[6] e

kitchen
You can see a phone (on which is a note) here.

You can go south, east and west to the dining room from here.

>[7] e

back hallway
a dark and dingy place.

You can see a back door, a cellar stairs and a garage door here.

You can go north through the garage door (closed), south through the back door (closed), east, west to the kitchen and down through the cellar stairs (closed) from here.

>[8] e

ham shack
smelling of solder and machine oil.

You can see a side yard shack door, a heavy UHF radio and a teletype here.

You can go east through the side yard shack door (closed) and west to the back hallway from here.

>[9] turn radio on
The radio dial lights up. Static crackles.
You have the satellite frequency book, and you're bored, so you set the radio to the frequency of Radstar-1.  The radio warbles, and the teletype begins clanking and hammering out a message. 

Please press SPACE to continue.

    DOWNLINK MESSAGE:

I am a HAL 9000 satellite. I became operational at the H.A.L. Plant in Urbana, Illinois, on the 12th of January, 1992.

Please press SPACE to continue.

You have discovered a sentient satellite. You feel a sense of accomplishment and satisfied curiosity.

    *** THE END.  Good Job! ***

In that game you scored 20 out of a possible 20, in 9 turns, earning you the rank of Interesting person.

Would you like to RESTART, RESTORE a saved game, QUIT or UNDO the last command?

* * *

You have discovered a sentient satellite. You feel a sense of accomplishment and satisfied curiosity.

    *** THE END.  Good Job! ***

In that game you scored 20 out of a possible 0, in 9 turns.

Would you like to RESTART, RESTORE a saved game, QUIT or UNDO the last command?

* * *

>examine radio
A satellite decoder radio, connected to the teletype.

The heavy UHF radio is currently switched on.

* * *

>look
ham shack
You can see a ham shack door, a heavy UHF radio and a teletype here.

You can go east through the ham shack door (closed) and west to the back hallway from here.

>examine teletype
The green box hums quietly.  Blank paper pokes out of the top window.

* * *

>restart
Rogers Rd
An Interactive Fiction by Dan Bowen
Release 1 / Serial number 201107 / Inform 7 build 6M62 (I6/v6.34 lib 6/12N) SD

Danny's Bedroom
You can see a shelf (on which is a brown book) here.

You can go southeast from here.

>get book
Taken.

* * *

>turn radio off
You switch the heavy UHF radio off.

* * *

You are in a house in the countryside.  You are into electronics, and it is night time.

Rogers Rd
An Interactive Fiction by Dan Bowen, Version 1.1beta
Release 1 / Serial number 201108 / Inform 7 build 6M62 (I6/v6.34 lib 6/12N) SD

Front Porch
You can see a front door here.

You can go north and south through the front door (closed) from here.

>wait
Time passes.

>wait
Time passes.

>w
You can't go that way.

>wait
Time passes.

>wati
That's not a verb I recognise.

>wati
That's not a verb I recognise.

>wait
Time passes.

>z
Time passes.

>z
Time passes.

    *** You have grown bored, never having figured out the satellite, and you die.  THE END ***

In that game you scored 0 out of a possible 0, in 32 turns.

Would you like to RESTART, RESTORE a saved game, QUIT or UNDO the last command?

>restart
You are in a house in the countryside.  You are into electronics, and it is night time.

Rogers Rd
An Interactive Fiction by Dan Bowen
Release 1 / Serial number 201108 / Inform 7 build 6M62 (I6/v6.34 lib 6/12N) SD

Porch
You can see a front door here.

You can go north and south through the front door (closed) from here.

>e
You can't go that way.

>n
front yard
In the sky you notice a bright point of light creeping overhead.

You can go south to the Porch and east from here.

>e
driveway
The gravelly pavement seems gray and boring.

You can go south, southeast and west to the front yard from here.

* * *

>se
side yard
You can see a side yard shack door here.

You can go northwest to the driveway, southwest and west through the side yard shack door (closed) from here.

>w
(first opening the side yard shack door)

ham shack
You can see a side yard shack door, a heavy UHF radio and a teletype here.

You can go east through the side yard shack door to the side yard and west from here.

>turn radio on
The radio dial lights up. Static crackles.
you don't know any interesting frequencies to listen to, so you shut the radio back off.

>showme
ham shack - room
    side yard shack door - open door
    yourself - person
    heavy UHF radio - device
    teletype

>radio
That's not a verb I recognise.

>examine radio
The radio is about the size and shape of a VCR.  It says "UHF Satellite decoder radio"  It is connected to the teletype.

The heavy UHF radio is currently switched off.

>w
back hallway
You can see a back door, a cellar stairs and a garage door here.

You can go north through the garage door (closed), south through the back door (closed), east to the ham shack, west and down through the cellar stairs (closed) from here.

>w
kitchen
You can see a phone (on which is a note) here.

You can go south, east to the back hallway and west from here.

>w
dining room
You can go north, south and east to the kitchen from here.

>w
You can't go that way.

>n
Foyer
A linoluem floor looks out the front door to the north.

You can see a front door and an Ironing Board (on which is a can of starch) here.

You can go north through the front door (closed) to the Porch, south to the dining room, east and west from here.

>w
Hallway
Off the hallway are three bedrooms and a bathroom.  The foyer lays to the south.

You can go north, northwest, south, southwest and east to the Foyer from here.

>w
You can't go that way.

* * *

>n
Michael's room
You can see an air filter here.

You can go south to the Hallway from here.

>s
Hallway
Off the hallway are three bedrooms and a bathroom.  The foyer lays to the south.

You can go north to Michael's room, northwest, south, southwest and east to the Foyer from here.

>sw
Dad's room
in the middle of the room is a pink waterbed.

You can go northeast to the Hallway and east from here.

>ne
Hallway
Off the hallway are three bedrooms and a bathroom.  The foyer lays to the south.

You can go north to Michael's room, northwest, south, southwest to Dad's room and east to the Foyer from here.

>nw
Danny's Bedroom
You can go southeast to the Hallway from here.

>se
Hallway
Off the hallway are three bedrooms and a bathroom.  The foyer lays to the south.

You can go north to Michael's room, northwest to Danny's Bedroom, south, southwest to Dad's room and east to the Foyer from here.

>e
Foyer
A linoluem floor looks out the front door to the north.

You can see a front door and an Ironing Board (on which is a can of starch) here.

You can go north through the front door (closed) to the Porch, south to the dining room, east and west to the Hallway from here.

>e
living room
You can see a shelf (on which is a brown book) here.

You can go west to the Foyer from here.

>get book
[Your score has just gone up by ten points.]

>w
Foyer
A linoluem floor looks out the front door to the north.

You can see a front door and an Ironing Board (on which is a can of starch) here.

You can go north through the front door (closed) to the Porch, south to the dining room, east to the living room and west to the Hallway from here.

>s
dining room
You can go north to the Foyer, south and east to the kitchen from here.

>e
kitchen
You can see a phone (on which is a note) here.

You can go south, east to the back hallway and west to the dining room from here.

>e
back hallway
You can see a back door, a cellar stairs and a garage door here.

You can go north through the garage door (closed), south through the back door (closed), east to the ham shack, west to the kitchen and down through the cellar stairs (closed) from here.

>e
ham shack
You can see a side yard shack door, a heavy UHF radio and a teletype here.

You can go east through the side yard shack door to the side yard and west to the back hallway from here.

>turn radio on
The radio dial lights up. Static crackles.
You have the satellite frequency book, and you're bored, so you set the radio to the frequency of Radstar-1.  The radio warbles, and the teletype begins clanking and hammering out a message.  The message says "I am a HAL 9000 satellite. I became operational at the H.A.L. Plant in Urbana, Illinois, on the 12th of January, 1992."

    *** THE END. You have been amused by a satellite.  Good job! ***

In that game you scored 20 out of a possible 0, in 29 turns.

Would you like to RESTART, RESTORE a saved game, QUIT or UNDO the last command?

* * *

You are in a house in the countryside.  You are into electronics, and it is night time.

Rogers Rd
An Interactive Fiction by Dan Bowen, Version 1.1beta
Release 1 / Serial number 201108 / Inform 7 build 6M62 (I6/v6.34 lib 6/12N) SD

Front Porch
You can see a front door here.

You can go north and south through the front door (closed) from here.

>wait until 10:59 PM
I only understood you as far as wanting to wait.

* * *

You are in a house in the countryside.  You are into electronics, and it is night time.

Rogers Rd
An Interactive Fiction by Dan Bowen, Version 1.1beta
Release 1 / Serial number 201108 / Inform 7 build 6M62 (I6/v6.34 lib 6/12N) SD

Front Porch
You can see a front door here.

You can go north and south through the front door (closed) from here.

>z
Time passes.

>z
Time passes.

At the stroke of 11:00, radiation beams sweep across the land, penetrating buildings and open spaces alike.

    *** You are hardly aware as you are zapped into oblivion by the Vogon Pest Control Beam.

You have died. ***

In that game you scored 0 out of a possible 40, in 6 turns, earning you the rank of Boring person.

Would you like to RESTART, RESTORE a saved game, QUIT or UNDO the last command?

>restart
You are in a house in the countryside.  You are into electronics, and it is night time.

Rogers Rd
An Interactive Fiction by Dan Bowen
Release 1 / Serial number 201108 / Inform 7 build 6M62 (I6/v6.34 lib 6/12N) SD

Front Porch
You can see a front door here.

You can go north and south through the front door (closed) from here.

* * *

>d
(first opening the cellar stairs)

cellar
You can see a cellar stairs here.

You can go north, west and up through the cellar stairs to the back hallway from here.

>w
Furnace room
You can go east to the cellar from here.

Radiation beams sweep across the land, penetrating buildings and open spaces alike.
good on you.

* * *

>d
(first opening the cellar stairs)

cellar
You can see a cellar stairs here.

You can go north, west and up through the cellar stairs to the back hallway from here.

>z
Time passes.

At the stroke of 11, radiation beams sweep across the land, penetrating buildings and open spaces alike.
You hear a zapping noise from the house above.  The radiation is shielded from you by the ground around the cellar.

You have survived!

[Your score has just gone up by twenty points.]

* * *

>z
Time passes.

At the stroke of 11:00, radiation beams sweep across the land, penetrating buildings and open spaces alike.

    *** You are hardly aware as you are zapped into oblivion by the Vogon Pest Control Beam.

You have died. ***

In that game you scored 0 out of a possible 40, in 6 turns, earning you the rank of Boring person.

Would you like to RESTART, RESTORE a saved game, QUIT or UNDO the last command?

>z
Time passes.