The sun has set outside.

You are in a house in the countryside.  You are into electronics, and it is 10:00 pm
Rogers Rd
An Interactive Fiction by Dan Bowen, Version 1.2beta
Release 1 / Serial number 201111 / Inform 7 build 6M62 (I6/v6.34 lib 6/12N) SD

Front Porch
You can see a front door here.

You can go north and south through the front door (closed) from here.

I beg your pardon?

>z
Time passes.

-- you hear the rumble of a truck pulling into the driveway. --

>z
Time passes.

-- you hear a loud thump from the area of the front porch, and then a truck roaring away. --

>test gen
(Testing.)

>[1] z
Time passes.

>[2] z
Time passes.

>[3] open box
You open the large wooden box, revealing a liquid methane generator and a liquid oxygen generator.

>[4] get all
liquid methane generator: Taken.
liquid oxygen generator: Taken.

>[5] examine methane generator
A metal frame containing a massive number of stainless steel tubes, valves, and electronic control systems. Printed on the side it says,

"Your  GasCo CH4 Generator will take ambient humid air and convert it into liquid methane.  It has an output pipe that is 1.5 inches in diameter. * Features convenient Drop-to-Connect pipe fittings.  Just drop the generator near your favorite pipe. *"

The liquid methane generator is currently switched off.

>[6] examine oxygen generator
A large, pink metal cabinet machine.  Printed on the side it says,

"Your  GasCo O2 Generator will take ambient air and convert it into liquid oxygen.  It has an output pipe that is 2 inches in diameter. * Features convenient Drop-to-Connect pipe fittings.   Just drop the generator near your favorite pipe. *"

The liquid oxygen generator is currently switched off.

>w
You can't go that way.

>n
front yard
In the sky you notice a bright point of light creeping overhead.

You can see a front yard hydrant and a blue hose here.

You can go south to the Front Porch, east and west from here.

>w
west side yard
A long flat lawn down the road from the house.

You can see an end of the red hose and an end of the blue hose here.

You can go southeast and east to the front yard from here.

>get hose
Which do you mean, the end of the red hose or the end of the blue hose?

>get the end of the red hose
Taken.

>examine hose
(the end of the red hose)
This is the end of the red hose.  The hose is apparently infinitely long, frictionless and a genuine vacuum jacketed garden hose.

>e
front yard
In the sky you notice a bright point of light creeping overhead.

You can see a front yard hydrant and a blue hose here.

You can go south to the Front Porch, east and west to the west side yard from here.

>i
You are carrying:
  an end of the red hose
  a liquid oxygen generator
  a liquid methane generator

* * *

The sun has set outside.

You are in a house in the countryside.  You are into electronics, and it is 10:00 pm
Rogers Rd
An Interactive Fiction by Dan Bowen, Version 1.2beta
Release 1 / Serial number 201111 / Inform 7 build 6M62 (I6/v6.34 lib 6/12N) SD

Front Porch
You can see a front door here.

You can go north and south through the front door (closed) from here.

>dw
That's not a verb I recognise.

>sw
Hallway
Off the hallway are three bedrooms and a bathroom.  The foyer lays to the south.

>e
Michael's room
You can see an air filter here.

>get all
(the air filter)
Taken.

* * *

The sun has set outside.

You are in a house in the countryside.  You are into electronics, and it is 10:00 pm
Rogers Rd
An Interactive Fiction by Dan Bowen, Version 1.2beta
Release 1 / Serial number 201111 / Inform 7 build 6M62 (I6/v6.34 lib 6/12N) SD

Front Porch
You can see a front door here.

You can go north and south through the front door (closed) from here.

>examine book
The book has the title "Satellite Frequencies."

* * *

The sun has set outside.

You are in a house in the countryside.  You are into electronics, and it is 10:00 pm
Rogers Rd
An Interactive Fiction by Dan Bowen, Version 1.2beta
Release 1 / Serial number 201111 / Inform 7 build 6M62 (I6/v6.34 lib 6/12N) SD

Front Porch
You can see a front door here.

You can go north and south through the front door (closed) from here.

>examine shelf
You can't see any such thing.

>look at shelf
You can't see any such thing.

>get book
You can't see any such thing.

>look
Danny's Bedroom
A brown shelf is in the corner.

You can go southeast from here.

* * *

The sun has set outside.

You are in a house in the countryside.  You are into electronics, and it is 10:00 pm
Rogers Rd
An Interactive Fiction by Dan Bowen, Version 1.2beta
Release 1 / Serial number 201111 / Inform 7 build 6M62 (I6/v6.34 lib 6/12N) SD

Front Porch
You can see a front door here.

You can go north and south through the front door (closed) from here.

>get book
[Your score has just gone up by ten points.]

>get book
You already have that.

>drop book
Dropped.

>get book
Taken.

* * *

>get book
[Your score has just gone up by ten points.]

>restart
Are you sure you want to restart?

>y
Rogers Rd
An Interactive Fiction by Dan Bowen
Release 1 / Serial number 201107 / Inform 7 build 6M62 (I6/v6.34 lib 6/12N) SD

Danny's Bedroom
You can see a shelf (on which is a brown book) here.

You can go southeast from here.

>get book
Taken.

* * *

>y
Rogers Rd
An Interactive Fiction by Dan Bowen
Release 1 / Serial number 201107 / Inform 7 build 6M62 (I6/v6.34 lib 6/12N) SD

Danny's Bedroom
You can see a shelf (on which is a brown book) here.

You can go southeast from here.

>se
Hallway
Off the hallway are three bedrooms and a bathroom.  The foyer lays to the south.

You can go north, northwest to Danny's Bedroom, south, southwest and east from here.

>e
Foyer
A linoluem floor looks out the front door to the north.

You can see a front door and an Ironing Board (on which is a can of starch) here.

You can go north through the front door (closed), south, east and west to the Hallway from here.

>s
dining room
You can go north to the Foyer, south and east from here.

>e
kitchen
You can go south, east and west to the dining room from here.

>e
back hallway
You can see a garage door and a cellar stairs here.

You can go north through the garage door (closed), south, east, west to the kitchen and down through the cellar stairs (closed) from here.

>e
ham shack
You can see a ham shack door, a heavy UHF radio and a teletype here.

You can go east through the ham shack door (closed) and west to the back hallway from here.

>turn radio on
The radio dial lights up. Static crackles.
you don't know any interesting frequencies to listen to, so you shut the radio back off.

* * *

>get book
[Your score has just gone up by ten points.]

>se
Hallway
Off the hallway are three bedrooms and a bathroom.  The foyer lays to the south.

You can go north, northwest to Danny's Bedroom, south, southwest and east from here.

* * *

>s
dining room
You can go north to the Foyer, south and east from here.

>ee
That's not a verb I recognise.

>e
kitchen
You can go south, east and west to the dining room from here.

* * *

>e
ham shack
You can see a ham shack door, a heavy UHF radio and a teletype here.

You can go east through the ham shack door (closed) and west to the back hallway from here.

>turn radio on
you have frequencies.

* * *

The sun has set outside.

You are in a house in the countryside.  You are into electronics, and it is 10:00 pm
Rogers Rd
An Interactive Fiction by Dan Bowen, Version 1.2beta
Release 1 / Serial number 201111 / Inform 7 build 6M62 (I6/v6.34 lib 6/12N) SD

Front Porch
You can see a front door here.

You can go north and south through the front door (closed) from here.

>look
Front Porch
You can see a front door here.

You can go north and south through the front door (closed) from here.

>e
You can't go that way.

>n
front yard
In the sky you notice a bright point of light creeping overhead.

You can go south to the Front Porch and east from here.

>x sky
There is a bright satellite passing overhead.

* * *

>look
Front Porch
You can see a front door here.

You can go north and south through the front door (closed) from here.

>n
front yard
In the sky you notice a bright point of light creeping overhead.

You can go south to the Front Porch and east from here.

>look at sky
There is a bright point of light creeping across the sky.

>examine sky
There is a bright point of light creeping across the sky.

>e
driveway
The gravelly pavement seems gray and boring.

You can go south, southeast and west to the front yard from here.

>look
driveway
The gravelly pavement seems gray and boring.

You can go south, southeast and west to the front yard from here.

>examine sky
There is a bright point of light creeping across the sky.

* * *

The sun has set outside.

You are in a house in the countryside.  You are into electronics, and it is 10:00 pm
Rogers Rd
An Interactive Fiction by Dan Bowen, Version 1.2beta
Release 1 / Serial number 201111 / Inform 7 build 6M62 (I6/v6.34 lib 6/12N) SD

Front Porch
You can see a front door here.

You can go north and south through the front door (closed) from here.

>look at shelf
You can't see any such thing.

>examine shelf
You can't see any such thing.

>open shelf
You can't see any such thing.

* * *

The sun has set outside.

You are in a house in the countryside.  You are into electronics, and it is 10:00 pm
Rogers Rd
An Interactive Fiction by Dan Bowen, Version 1.2beta
Release 1 / Serial number 201111 / Inform 7 build 6M62 (I6/v6.34 lib 6/12N) SD

Front Porch
You can see a front door here.

You can go north and south through the front door (closed) from here.

>n
front yard
In the sky you notice a bright point of light creeping overhead.

You can go south to the Front Porch, east, and west from here.

>e
driveway
The gravelly pavement seems gray and boring.

You can go south, southeast, and west to the front yard from here.

>e
You can't go that way.

>s
garage
You can see a garage door here.

You can go north to the driveway and south through the garage door (closed) from here.

>n
driveway
The gravelly pavement seems gray and boring.

You can go south to the garage, southeast, and west to the front yard from here.

>n
You can't go that way.

>e
You can't go that way.

>se
side yard
You can see a side yard shack door here.

You can go northwest to the driveway, southwest, and west through the side yard shack door (closed) from here.

>s
You can't go that way.

>sw
back yard hill
You can see an antenna pole (on which is a dish) here.

You can go north, northeast to the side yard, northwest, and south from here.

>x dish
The dish is slowly tracking a bright spot in the sky.

>s
Darkness
It is pitch dark, and you can't see a thing.

You can go north to the back yard hill from here.

>n
back yard hill
You can see an antenna pole (on which is a dish) here.

You can go north, northeast to the side yard, northwest, and south from here.

>restart
Are you sure you want to restart?

>y
The sun has set outside.

You are in a house in the countryside.  You are into electronics, and it is 10:00 pm
Rogers Rd
An Interactive Fiction by Dan Bowen, Version 1.2beta
Release 1 / Serial number 201110 / Inform 7 build 6M62 (I6/v6.34 lib 6/12N) SD

Front Porch
You can see a front door here.

You can go north and south through the front door (closed) from here.

>test radiation
(Testing.)

>[1] test radio
(Testing.)

>[2] s
(first opening the front door)

Foyer
Lined with a linoluem floor.

You can see a front door and an Ironing Board (on which is a can of starch) here.

You can go north through the front door to the Front Porch, south, east, and west from here.

>[3] e

living room
You can see a shelf (on which is a brown book) here.

You can go west to the Foyer from here.

>[4] get book
[Your score has just gone up by ten points.]

>[5] w

Foyer
Lined with a linoluem floor.

You can see a front door and an Ironing Board (on which is a can of starch) here.

You can go north through the front door to the Front Porch, south, east to the living room, and west from here.

>[6] s

dining room
This room has a green rug.

You can go north to the Foyer, south, and east from here.

>[7] e

kitchen
You can see a phone (on which is a note) here.

You can go south, east, and west to the dining room from here.

>[8] e

back hallway
a dark and dingy place.

You can see a back door, a cellar stairs, and a garage door here.

You can go north through the garage door (closed), south through the back door (closed), east, west to the kitchen, and down through the cellar stairs (closed) from here.

>[9] e

ham shack
smelling of solder and machine oil.

You can see a side yard shack door, a heavy UHF radio, and a teletype here.

You can go east through the side yard shack door (closed) and west to the back hallway from here.

>[10] turn radio on
The radio dial lights up. Static crackles.
You have the satellite frequency book, and you're bored, so you set the radio to the frequency of Radstar-1.  The radio warbles, and the teletype begins clanking and hammering out a message. 

Please press SPACE to continue.

* * *

** Good morning ** The time is now 8:00 am!

Michael's room
You can see an air filter here.

You can go south from here.

The sun is up outside.

>[72] z
Time passes.

>[73] z
Time passes.

>[74] z
Time passes.

>[75] z
Time passes.

>[76] 
I beg your pardon?

>s
Hallway
You can go north to Michael's room, northwest, south, southwest, and east to the Foyer from here.

-- you hear the rumble of a truck pulling into the driveway. --

>e
Foyer
Lined with a linoluem floor.

You can see a front door and an Ironing Board (on which is a can of starch) here.

You can go north through the front door to the Front Porch, south to the dining room, east to the living room, and west to the Hallway from here.

>e
living room
You can see a shelf here.

You can go west to the Foyer from here.

>w
Foyer
Lined with a linoluem floor.

You can see a front door and an Ironing Board (on which is a can of starch) here.

You can go north through the front door to the Front Porch, south to the dining room, east to the living room, and west to the Hallway from here.

>s
dining room
This room has a green rug.

You can go north to the Foyer, south, and east to the kitchen from here.

>e
kitchen
You can see a phone (on which is a note) here.

You can go south, east to the back hallway, and west to the dining room from here.

-- you hear a loud thump from the area of the front porch, and then a truck roaring away. --

>e
back hallway
a dark and dingy place.

You can see a cellar stairs, a back door, and a garage door here.

You can go north through the garage door (closed), south through the back door (closed), east to the ham shack, west to the kitchen, and down through the cellar stairs to the cellar from here.

>s
(first opening the back door)

back porch
You can see a back door here.

You can go north through the back door to the back hallway and south from here.

>s
back yard hill
You can see an antenna pole (on which is a dish) here.

You can go north to the back porch, northeast, northwest, and south from here.

>s
middle back yard
You can see a red hose and a back yard hydrant here.

You can go north to the back yard hill from here.

* * *

>e
driveway
The gravelly pavement seems gray and boring.

You can go south, southeast, and west to the front yard from here.

>examine sky
You can't see any such thing.

>look
driveway
The gravelly pavement seems gray and boring.

You can go south, southeast and west to the front yard from here.

* * *

>e
driveway
The gravelly pavement seems gray and boring.

You can go south, southeast, and west to the front yard from here.

>se
side yard
You can see a side yard shack door here.

You can go northwest to the driveway, southwest and west through the side yard shack door (closed) from here.

>sw
back yard hill
You can see an antenna here.

You can go north, northeast to the side yard and south from here.

>examine antenna
The antenna pole is tall, and has a satellite dish on top.  The disk is slowly tracking a bright spot in the sky.

>s
middle back yard
You can see a sky (in which is a satellite) here.

You can go north to the back yard hill from here.

>n
back yard hill
You can see an antenna here.

You can go north, northeast to the side yard and south to the middle back yard from here.

>n
back porch
You can see a back door here.

You can go north through the back door (closed) and south to the back yard hill from here.

>n
(first opening the back door)

back hallway
You can see a back door, a cellar stairs and a garage door here.

You can go north through the garage door (closed), south through the back door to the back porch, east, west and down through the cellar stairs (closed) from here.

>d
(first opening the cellar stairs)

cellar
You can see a cellar stairs here.

You can go north, west and up through the cellar stairs to the back hallway from here.

>n
radiostation
A suite of electronics is jammed into the small room. There is nothing to do here, it appears fully automated.

You can go south to the cellar from here.

>s
cellar
You can see a cellar stairs here.

You can go north to the radiostation, west and up through the cellar stairs to the back hallway from here.

>w
Furnace room
You can go east to the cellar from here.

>e
cellar
You can see a cellar stairs here.

You can go north to the radiostation, west to the Furnace room and up through the cellar stairs to the back hallway from here.

>s
You can't go that way.

>u
back hallway
You can see a cellar stairs, a back door and a garage door here.

You can go north through the garage door (closed), south through the back door to the back porch, east, west and down through the cellar stairs to the cellar from here.

* * *

>n
front yard
In the sky you notice a bright point of light creeping overhead.

You can go south to the Front Porch, east, and west from here.

>examine blue hose
You see nothing special about the blue hose.

-- you hear a loud thump from the area of the front porch, and then a truck roaring away. --

>examine hydrant
A gray metal pipe topped with a blue handle.  A blue garden hose is firmly rusted on to the output threads.

* * *

>n
front yard
In the sky you notice a bright point of light creeping overhead.

You can go south to the Front Porch, east, and west from here.

>examine hose
The blue hose is connected to the hydrant permanently and snakes over into the west side yard. 

-- you hear a loud thump from the area of the front porch, and then a truck roaring away. --

>w
west side yard
A long flat lawn down the road from the house.

You can see an end of the red hose and an end of the blue hose here.

You can go southeast and east to the front yard from here.

>examine
What do you want to examine?

>red
This is the end of the red hose.  It snakes off toward the back yard. The hose is apparently infinitely long, frictionless and a genuine vacuum jacketed garden hose.

>get
What do you want to get?

>all
There are none at all available!

* * *

>n
front yard
In the sky you notice a bright point of light creeping overhead.

You can go south to the Front Porch, east, and west from here.

>examine hydrant
A gray metal pipe topped with a blue handle. A blue garden hose is firmly rusted on to the output threads.

-- you hear a loud thump from the area of the front porch, and then a truck roaring away. --

>examine hose
You can't see any such thing.

>look
front yard
In the sky you notice a bright point of light creeping overhead.

You can see a front yard hydrant here.

You can go south to the Front Porch, east and west from here.

* * *

>n
front yard
In the sky you notice a bright point of light creeping overhead.

You can go south to the Front Porch, east, and west from here.

>get hose
That's fixed in place.

>x hose
The blue hose is connected to the hydrant permanently and snakes over into the west side yard.

>x hydrant
A gray metal pipe topped with a blue handle.  A blue garden hose is firmly rusted on to the output threads.

The front yard hydrant is currently switched off.

* * *

>n
front yard
In the sky you notice a bright point of light creeping overhead.

You can go south to the Front Porch, east, and west from here.

>turn hydrant on
You switch the front yard hydrant on.

-- you hear a loud thump from the area of the front porch, and then a truck roaring away. --

* * *

>n
front yard
In the sky you notice a bright point of light creeping overhead.

You can go south to the Front Porch, east, and west from here.

>w
Darkness
It is pitch dark, and you can't see a thing.

You can go east to the front yard from here.

>s
You can't go that way.

>se
back yard hill
You can see an antenna pole (on which is a dish) here.

You can go north, northeast, northwest, and south from here.

>n
back porch
You can see a back door here.

You can go north through the back door (closed) and south to the back yard hill from here.

>n
(first opening the back door)

back hallway
a dark and dingy place.

You can see a back door, a cellar stairs, and a garage door here.

You can go north through the garage door (closed), south through the back door to the back porch, east, west, and down through the cellar stairs (closed) from here.

>d
(first opening the cellar stairs)

cellar
You can see a cellar stairs here.

You can go north, west, and up through the cellar stairs to the back hallway from here.

>restart
Are you sure you want to restart?

>y
You are in a house in the countryside.  You are into electronics, and it is 10:00 pm
Rogers Rd
An Interactive Fiction by Dan Bowen, Version 1.2beta
Release 1 / Serial number 201110 / Inform 7 build 6M62 (I6/v6.34 lib 6/12N) SD

Front Porch
You can see a front door here.

You can go north and south through the front door (closed) from here.

>test radiation
(Testing.)

>[1] test radio
(Testing.)

>[2] s
(first opening the front door)

Foyer
Lined with a linoluem floor.

You can see a front door and an Ironing Board (on which is a can of starch) here.

You can go north through the front door to the Front Porch, south, east, and west from here.

>[3] e

living room
You can see a shelf (on which is a brown book) here.

You can go west to the Foyer from here.

>[4] get book
[Your score has just gone up by ten points.]

>[5] w

Foyer
Lined with a linoluem floor.

You can see a front door and an Ironing Board (on which is a can of starch) here.

You can go north through the front door to the Front Porch, south, east to the living room, and west from here.

>[6] s

dining room
This room has a green rug.

You can go north to the Foyer, south, and east from here.

>[7] e

kitchen
You can see a phone (on which is a note) here.

You can go south, east, and west to the dining room from here.

>[8] e

back hallway
a dark and dingy place.

You can see a back door, a cellar stairs, and a garage door here.

You can go north through the garage door (closed), south through the back door (closed), east, west to the kitchen, and down through the cellar stairs (closed) from here.

>[9] e

ham shack
smelling of solder and machine oil.

You can see a side yard shack door, a heavy UHF radio, and a teletype here.

You can go east through the side yard shack door (closed) and west to the back hallway from here.

>[10] turn radio on
The radio dial lights up. Static crackles.
You have the satellite frequency book, and you're bored, so you set the radio to the frequency of Radstar-1.  The radio warbles, and the teletype begins clanking and hammering out a message. 

Please press SPACE to continue.

* * *

>w
Darkness
It is pitch dark, and you can't see a thing.

You can go east to the front yard from here.

>se
back yard hill
You can see an antenna pole (on which is a dish) here.

You can go north, northeast, northwest, and south from here.

>s
Darkness
It is pitch dark, and you can't see a thing.

You can go north to the back yard hill from here.

>get hose
That's fixed in place.

>get hydrant
That's fixed in place.

* * *

>s
Darkness
It is pitch dark, and you can't see a thing.

You can go north to the back yard hill from here.

>n
back yard hill
You can see an antenna pole (on which is a dish) here.

You can go north, northeast, northwest, and south from here.

* * *

The sun has set outside.

You are in a house in the countryside.  You are into electronics, and it is 10:00 pm
Rogers Rd
An Interactive Fiction by Dan Bowen, Version 1.2beta
Release 1 / Serial number 201111 / Inform 7 build 6M62 (I6/v6.34 lib 6/12N) SD

Front Porch
You can see a front door here.

You can go north and south through the front door (closed) from here.

>s
(first opening the front door)

Foyer
Lined with a linoluem floor.

You can see a front door and an Ironing Board (on which is a can of starch) here.

You can go north through the front door to the Front Porch, south, east, and west from here.

>e
living room
You can see a shelf (on which is a brown book) here.

You can go west to the Foyer from here.

>e
You can't go that way.

>w
Foyer
Lined with a linoluem floor.

You can see a front door and an Ironing Board (on which is a can of starch) here.

You can go north through the front door to the Front Porch, south, east to the living room, and west from here.

>s
dining room
This room has a green rug.

You can go north to the Foyer, south, and east from here.

>e
kitchen
You can see a phone (on which is a note) here.

You can go south, east, and west to the dining room from here.

>e
back hallway
a dark and dingy place.

You can see a back door, a cellar stairs, and a garage door here.

You can go north through the garage door (closed), south through the back door (closed), east, west to the kitchen, and down through the cellar stairs (closed) from here.

>e
ham shack
smelling of solder and machine oil.

You can see a side yard shack door, a heavy UHF radio, and a teletype here.

You can go east through the side yard shack door (closed) and west to the back hallway from here.

>w
back hallway
a dark and dingy place.

You can see a back door, a cellar stairs, and a garage door here.

You can go north through the garage door (closed), south through the back door (closed), east to the ham shack, west to the kitchen, and down through the cellar stairs (closed) from here.

>d
(first opening the cellar stairs)

cellar
You can see a cellar stairs here.

You can go north, west, and up through the cellar stairs to the back hallway from here.

>wait 10 minutes
I only understood you as far as wanting to wait.

>wait until 11 PM
--- You notice a faint sound in the far distance, as if a ray gun were charging up. ----
The time is now 11:00 pm.

At the stroke of 11:00, radiation beams sweep across the land, penetrating buildings and open spaces alike.
You hear a zapping noise from the house above.  The ground around the cellar has blocked the radiation beams from burninating you.

You have survived!

[Your score has just gone up by twenty points.]

I beg your pardon?

>wait
Time passes.

>z
Time passes.

>z
Time passes.

>wait until 12 am
You grow tired, and you decide to lay down here and sleep till morning.

-- you hear the rumble of a truck pulling into the driveway. --
-- you hear a loud thump from the area of the front porch, and then a truck roaring away. --
The time is now 12:00 am.

* * *

>w
Foyer
Lined with a linoluem floor.

You can see a front door and an Ironing Board (on which is a can of starch) here.

You can go north through the front door to the Front Porch, south, east to the living room, and west from here.

>ws
That's not a verb I recognise.

>s
dining room
This room has a green rug.

You can go north to the Foyer, south, and east from here.

* * *

>e
kitchen
You can see a phone (on which is a note) here.

You can go south, east, and west to the dining room from here.

>e
back hallway
a dark and dingy place.

You can see a back door, Cellar stairs, and a garage door here.

You can go north through the garage door (closed), south through the back door (closed), east, west to the kitchen, and down through Cellar stairs from here.

>d
cellar
You can see Cellar stairs here.

You can go north, west, and up through Cellar stairs to the back hallway from here.

>n
radiostation
A suite of electronics is jammed into the small room. There is nothing to do with them, it appears fully automated.

You can see a teal pipe here.

You can go south to the cellar from here.

* * *

>e
living room
You can see a shelf (on which is a brown book) here.

You can go west to the Foyer from here.

>get
(the shelf)
That's fixed in place.

>get book
[Your score has just gone up by ten points.]

>w
Foyer
Lined with a linoluem floor.

You can see a front door and an Ironing Board (on which is a can of starch) here.

You can go north through the front door to the Front Porch, south, east to the living room and west from here.

>s
dining room
This room has a green rug.

You can go north to the Foyer, south and east from here.

>e
kitchen
You can see a phone (on which is a note) here.

You can go south, east and west to the dining room from here.

>e
back hallway
a dark and dingy place.

You can see a back door, a cellar stairs and a garage door here.

You can go north through the garage door (closed), south through the back door (closed), east, west to the kitchen and down through the cellar stairs (closed) from here.

>e
ham shack
smelling of solder and machine oil.

You can see a side yard shack door, a heavy UHF radio and a teletype here.

You can go east through the side yard shack door (closed) and west to the back hallway from here.

>turn radio on
The radio dial lights up. Static crackles.
You have the satellite frequency book, and you're bored, so you set the radio to the frequency of Radstar-1.  The radio warbles, and the teletype begins clanking and hammering out a message. 

Please press SPACE to continue.

DOWNLINK MESSAGE:

I am a HAL 9000 satellite. I became operational at the H.A.L. Plant in Urbana, Illinois, on the 12th of January, 1992.

All buildings are to be irradiated from space by Vogon Pest Control at 11:00PM.  Humans are advised to be below ground level to avoid certain doom.

[Your score has just gone up by ten points.]

>w
back hallway
a dark and dingy place.

You can see a back door, a cellar stairs and a garage door here.

You can go north through the garage door (closed), south through the back door (closed), east to the ham shack, west to the kitchen and down through the cellar stairs (closed) from here.

>s
(first opening the back door)

back porch
You can see a back door here.

You can go north through the back door to the back hallway and south from here.

>d
You can't go that way.

>z
Time passes.

>z
Time passes.

At the stroke of 11, radiation beams sweep across the land, penetrating buildings and open spaces alike.

    *** You are hardly aware as you are zapped into oblivion by the Vogon Pest Control Beam.

You have died. ***

In that game you scored 20 out of a possible 40, in 61 turns, earning you the rank of interesting person.

Would you like to RESTART, RESTORE a saved game, QUIT or UNDO the last command?

>undo
back porch
[Previous turn undone.]

>undo
back porch
[Previous turn undone.]

>n
back hallway
a dark and dingy place.

You can see a back door, a cellar stairs and a garage door here.

You can go north through the garage door (closed), south through the back door to the back porch, east to the ham shack, west to the kitchen and down through the cellar stairs (closed) from here.

>d
(first opening the cellar stairs)

cellar
You can see a cellar stairs here.

You can go north, west and up through the cellar stairs to the back hallway from here.

At the stroke of 11, radiation beams sweep across the land, penetrating buildings and open spaces alike.You hear a zapping noise from the house above.  The radiation is shielded from you by the ground around the cellar.

You have survived!

[Your score has just gone up by twenty points.]

* * *

>e
living room
You can see a shelf (on which is a brown book) here.

You can go west to the Foyer from here.

>get all
brown book: [Your score has just gone up by ten points.]

>w
Foyer
Lined with a linoluem floor.

You can see a front door and an Ironing Board (on which is a can of starch) here.

You can go north through the front door to the Front Porch, south, east to the living room and west from here.

* * *

>turn radio on
The radio dial lights up. Static crackles.
You have the satellite frequency book, and you're bored, so you set the radio to the frequency of Radstar-1.  The radio warbles, and the teletype begins clanking and hammering out a message. 

Please press SPACE to continue.

DOWNLINK MESSAGE:

I am a HAL 9000 satellite. I became operational at the H.A.L. Plant in Urbana, Illinois, on the 12th of January, 1992.

Please press SPACE to continue.

* * *

All buildings are to be irradiated from space by Vogon Pest Control at 11:30PM.  Humans are advised to be below ground level to avoid certain doom.

[Your score has just gone up by ten points.]

* * *

>e
living room
You can see a shelf (on which is a brown book) here.

You can go west to the Foyer from here.

>w
Foyer
Lined with a linoluem floor.

You can see a front door and an Ironing Board (on which is a can of starch) here.

You can go north through the front door to the Front Porch, south, east to the living room, and west from here.

* * *

>e
kitchen
You can see a phone (on which is a note) here.

You can go south, east, and west to the dining room from here.

>e
back hallway
a dark and dingy place.

You can see a back door, a cellar stairs, and a garage door here.

You can go north through the garage door (closed), south through the back door (closed), east, west to the kitchen, and down through the cellar stairs from here.

>d
cellar
You can see a cellar stairs here.

You can go north, west, and up through the cellar stairs to the back hallway from here.

>x cellar stairs
You see nothing special about the cellar stairs.

* * *

>s
(first opening the front door)

Foyer
Lined with a linoluem floor.

You can see a front door and an Ironing Board (on which is a can of starch) here.

You can go north through the front door to the Front Porch, south, east, and west from here.

>n
Porch
You can see a front door here.

You can go north and south through the front door to the Foyer from here.

>test me
(Testing.)

>[1] s

Foyer
A linoluem floor looks out the front door to the north.

You can see a front door and an Ironing Board (on which is a can of starch) here.

You can go north through the front door to the Porch, south, east and west from here.

>[2] e

living room
You can see a shelf (on which is a brown book) here.

You can go west to the Foyer from here.

>[3] get book
[Your score has just gone up by ten points.]

>[4] w

Foyer
A linoluem floor looks out the front door to the north.

You can see a front door and an Ironing Board (on which is a can of starch) here.

You can go north through the front door to the Porch, south, east to the living room and west from here.

>[5] s

dining room
You can go north to the Foyer, south and east from here.

>[6] e

kitchen
You can see a phone (on which is a note) here.

You can go south, east and west to the dining room from here.

>[7] e

back hallway
You can see a back door, a cellar stairs and a garage door here.

You can go north through the garage door (closed), south through the back door (closed), east, west to the kitchen and down through the cellar stairs (closed) from here.

>[8] e

ham shack
You can see a side yard shack door, a heavy UHF radio and a teletype here.

You can go east through the side yard shack door (closed) and west to the back hallway from here.

>[9] turn radio on
The radio dial lights up. Static crackles.
You have the satellite frequency book, and you're bored, so you set the radio to the frequency of Radstar-1.  The radio warbles, and the teletype begins clanking and hammering out a message.  The message says "I am a HAL 9000 satellite. I became operational at the H.A.L. Plant in Urbana, Illinois, on the 12th of January, 1992."

    *** THE END. You have been amused by a satellite.  Good job! ***

In that game you scored 20 out of a possible 0, in 11 turns.

Would you like to RESTART, RESTORE a saved game, QUIT or UNDO the last command?

* * *

>s
(first opening the front door)

Foyer
Lined with a linoluem floor.

You can see a front door and an Ironing Board (on which is a can of starch) here.

You can go north through the front door to the Front Porch, south, east, and west from here.

>s
dining room
This room has a green rug.

You can go north to the Foyer, south, and east from here.

* * *

>d
cellar
You can see Cellar stairs here.

You can go north, west, and up through Cellar stairs to the back hallway from here.

>n
Radiostation
The size of a closet, there is about 2x4 feet of space to move around next to the table.

You can see a suite of audio equipment and a teal pipe here.

You can go south to the cellar from here.

>examine pipe
 A 1.5 pipe is sticking out of the wall.

>get pipe
That's fixed in place.

* * *

>n
Radiostation
The size of a closet, there is about 2x4 feet of space to move around next to the table.

You can see a suite of audio equipment and a teal pipe here.

You can go south to the cellar from here.

>turn equipment on
The equipment starts humming and bits of them start glowing.

>s
cellar
ON AIR

You can go north to the Radiostation, west, and up through Cellar stairs to the back hallway from here.

* * *

>n
Radiostation
The size of a closet, there is about 2x4 feet of space to move around next to the table.

You can see a suite of audio equipment and a teal pipe here.

You can go south to the cellar from here.

>x pipe
 A 1.5 inch teal pipe is sticking out of the wall.  You notice that it ends in a Tee.  One branch of the Tee is open and available to connect.  The other branch returns into the wall, with a tag stating, "To Front Yard Hydrant ^"

>x equipment
There are various boxes that have dark dials and do not hum.

The suite of audio equipment is currently switched off.

>turn equipment on
The equipment starts humming and bits of them start glowing.

>x equipmemnt
You can't see any such thing.

>x audio
The various boxes have glowing dials and humming motors.

The suite of audio equipment is currently switched on.

* * *

>d
cellar
You can see Cellar stairs here.

You can go north, west, and up through Cellar stairs to the back hallway from here.

>test wait
(Testing.)

>[1] I beg your pardon?
I beg your pardon?

>[2] z
Time passes.

>[3] z
Time passes.

>[4] z
Time passes.

>[5] z
Time passes.

>[6] z
Time passes.

>[7] z
Time passes.

>[8] z
Time passes.

>[9] z
Time passes.

>[10] z
Time passes.

>[11] z
Time passes.

>[12] z
Time passes.

>[13] z
Time passes.

>[14] z
Time passes.

>[15] z
Time passes.

>[16] z
Time passes.

>[17] z
Time passes.

>[18] z
Time passes.

>[19] z
Time passes.

>[20] z
Time passes.

>[21] z
Time passes.

>[22] z
Time passes.

>[23] z
Time passes.

>[24] z
Time passes.

>[25] z
Time passes.

>[26] z
Time passes.

>[27] z
Time passes.

>[28] z
Time passes.

>[29] z
Time passes.

>[30] z
Time passes.

>[31] z
Time passes.

>[32] z
Time passes.

>[33] z
Time passes.

>[34] z
Time passes.

>[35] z
Time passes.

>[36] z
Time passes.

>[37] z
Time passes.

>[38] z
Time passes.

>[39] z
Time passes.

>[40] z
Time passes.

>[41] z
Time passes.

>[42] z
Time passes.

>[43] z
Time passes.

>[44] z
Time passes.

>[45] z
Time passes.

>[46] z
Time passes.

>[47] z
Time passes.

--- You notice a faint sound in the far distance, as if a ray gun were charging up. ----
>[48] z
Time passes.

>[49] z
Time passes.

>[50] z
Time passes.

>[51] z
Time passes.

>[52] I beg your pardon?
I beg your pardon?

>z
Time passes.

>z
Time passes.

At the stroke of 11:00, radiation beams sweep across the land, penetrating buildings and open spaces alike.
You hear a zapping noise from the house above.  The ground around the cellar has blocked the radiation beams from burninating you.

You have survived!

[Your score has just gone up by twenty points.]

>z
Time passes.

>z
Time passes.

You grow tired, and you decide to go back to bed and sleep till morning...

Please press SPACE to continue.

** Good morning ** The time is now 8:00 am!

* * *

>z
Time passes.

You grow tired, and you decide to go back to bed and sleep till morning...

Please press SPACE to continue.

>z
Time passes.

>z
Time passes.

You grow tired, and you decide to lay down here and sleep till morning.  The time is now 8:00 am

>z
Time passes.

>z
Time passes.

-- you hear the rumble of a truck pulling into the driveway. --

>z
Time passes.

>z
Time passes.

-- you hear a loud thump from the area of the front porch, and then a truck roaring away. --

>z
Time passes.

>u
back hallway
a dark and dingy place.

You can see a cellar stairs, a back door, and a garage door here.

You can go north through the garage door (closed), south through the back door (closed), east, west to the kitchen, and down through the cellar stairs to the cellar from here.

>w
kitchen
You can see a phone (on which is a note) here.

You can go south, east to the back hallway, and west to the dining room from here.

>w
dining room
This room has a green rug.

You can go north to the Foyer, south, and east to the kitchen from here.

>u
You can't go that way.

>n
Foyer
Lined with a linoluem floor.

You can see a front door and an Ironing Board (on which is a can of starch) here.

You can go north through the front door to the Front Porch, south to the dining room, east, and west from here.

>n
Front Porch
You can see a front door and a large wooden box (closed) here.

You can go north and south through the front door to the Foyer from here.

>x sky
The sky is pretty blue.

* * *

>d
cellar
You can see Cellar stairs here.

You can go north, west, and up through Cellar stairs to the back hallway from here.

>w
Furnace room
You can go east to the cellar from here.

Radiation beams sweep across the land, penetrating buildings and open spaces alike.
You hear a zapping noise from the house above.  The radiation is shielded from you by the ground around the cellar.

You have survived!

[Your score has just gone up by twenty points.]

* * *

>d
cellar
You can see Cellar stairs here.

You can go north, west, and up through Cellar stairs to the back hallway from here.

>wait until 1 am
--- You notice a faint sound in the far distance, as if a ray gun were charging up. ----
At the stroke of 11:00, radiation beams sweep across the land, penetrating buildings and open spaces alike.
You hear a zapping noise from the house above.  The ground around the cellar has blocked the radiation beams from burninating you.

You have survived!

[Your score has just gone up by twenty points.]

You grow tired, and you decide to lay down here and sleep till morning.

-- you hear the rumble of a truck pulling into the driveway. --
-- you hear a loud thump from the area of the front porch, and then a truck roaring away. --
Now the moon is up.

The time is now 1:00 am.

* * *

>d
cellar
You can see Cellar stairs here.

You can go north, west, and up through Cellar stairs to the back hallway from here.

>wait until 11 pm
--- You notice a faint sound in the far distance, as if a ray gun were charging up. ----
The time is now 11:00 pm.

At the stroke of 11:00, radiation beams sweep across the land, penetrating buildings and open spaces alike.
You hear a zapping noise from the house above.  The ground around the cellar has blocked the radiation beams from burninating you.

You have survived!

[Your score has just gone up by twenty points.]

I beg your pardon?

>z
Time passes.

>wait until 11:30 pm
You grow tired, and you decide to lay down here and sleep till morning.  The time is now 8:00 am
-- you hear the rumble of a truck pulling into the driveway. --
-- you hear a loud thump from the area of the front porch, and then a truck roaring away. --
The time is now 11:30 pm.

* * *

>d
cellar
You can see Cellar stairs here.

You can go north, west, and up through Cellar stairs to the back hallway from here.

>z
Time passes.

At the stroke of 11:00, radiation beams sweep across the land, penetrating buildings and open spaces alike.
You hear a zapping noise from the house above.  The ground around the cellar has blocked the radiation beams from burninating you.

You have survived!

    *** The End ***

In that game you scored 20 out of a possible 40, in 6 turns, earning you the rank of interesting person.

Would you like to RESTART, RESTORE a saved game, QUIT or UNDO the last command?

* * *

>e
back hallway
a dark and dingy place.

You can see a back door, Cellar stairs, and a garage door here.

You can go north through the garage door (closed), south through the back door (closed), east, west to the kitchen, and down through Cellar stairs from here.

>s
(first opening the back door)

back porch
You can see a back door here.

You can go north through the back door to the back hallway and south from here.

>s
back yard hill
You can see an antenna pole (on which is a dish) here.

You can go north to the back porch, northeast and south from here.

>examine pole
The antenna pole is tall, and has a satellite dish on top.

On the antenna pole is a dish.

>examine pole
The antenna pole is tall, and has a satellite dish on top.

On the antenna pole is a dish.

>examine dish
The dish is slowly tracking a bright spot in the sky.

>get dish
Taken.

>get on the pole
That's not something you can enter.

* * *

>s
dining room
This room has a green rug.

You can go north to the Foyer, south, and east from here.

>s
New room west
this room is big.

You can go north to the dining room and east from here.

>s
You can't go that way.

>s
You can't go that way.

>s
You can't go that way.

At the stroke of 11:00, radiation beams sweep across the land, penetrating buildings and open spaces alike.
You are hardly aware as you are zapped into oblivion by the Vogon Pest Control Beam. end the story finally saying

You have died.

    *** The End ***

In that game you scored 0 out of a possible 40, in 6 turns, earning you the rank of Boring person.

Would you like to RESTART, RESTORE a saved game, QUIT or UNDO the last command?

>s
Please give one of the answers above.

Would you like to RESTART, RESTORE a saved game, QUIT or UNDO the last command?

>restart
You are in a house in the countryside.  You are into electronics, and it is night time.

Rogers Rd
An Interactive Fiction by Dan Bowen
Release 1 / Serial number 201108 / Inform 7 build 6M62 (I6/v6.34 lib 6/12N) SD

Front Porch
You can see a front door here.

You can go north and south through the front door (closed) from here.

>s
(first opening the front door)

Foyer
Lined with a linoluem floor.

You can see a front door and an Ironing Board (on which is a can of starch) here.

You can go north through the front door to the Front Porch, south, east and west from here.

>s
dining room
This room has a green rug.

You can go north to the Foyer, south and east from here.

* * *

>e
back hallway
a dark and dingy place.

You can see a back door, a cellar stairs and a garage door here.

You can go north through the garage door (closed), south through the back door (closed), east, west to the kitchen and down through the cellar stairs (closed) from here.

>d
(first opening the cellar stairs)

cellar
You can see a cellar stairs here.

You can go north, west and up through the cellar stairs to the back hallway from here.

>z
Time passes.

At the stroke of 11:00, radiation beams sweep across the land, penetrating buildings and open spaces alike.
You hear a zapping noise from the house above.  The ground around the cellar has blocked the radiation beams from burninating you.

You have survived!

    *** The End ***

In that game you scored 20 out of a possible 40, in 6 turns, earning you the rank of interesting person.

Would you like to RESTART, RESTORE a saved game, QUIT or UNDO the last command?

* * *

>s
(first opening the front door)

Foyer
Lined with a linoluem floor.

You can see a front door and an Ironing Board (on which is a can of starch) here.

You can go north through the front door to the Front Porch, south, east, and west from here.

>w
Mid Hallway
You can go north, south, east to the Foyer, and west from here.

>s
Dad's bathroom
The Panasonic multiband radio is off.

You can go north to Mid Hallway and west from here.

* * *

>w
Mid Hallway
You can go north, south, east to the Foyer, and west from here.

>sw
Dad's room
in the middle of the room is a pink waterbed.

You can go northeast to the Hallway and east from here.

>e
Dad's bathroom
The Panasonic multiband radio is off.

You can go west to Dad's room from here.

>turn radio
It is fixed in place.

>turn radio on
You switch the Panasonic Radio on.

..AST AM, PAVILION NEW YORK! (a monty python song jangles): "1070 ON YOUR DIAL!"

>z
Time passes.

This is a recorded broadcast...
: "Well that was In the mood by Glenn Miller, up next is Johnny B goode."

>z
Time passes.

The radio broadcast continues: "Umm, (chunks, clatter, and clunks are heard in the bathroom."

>z
Time passes.

The radio broadcast continues: "Who knows what evil lurks..."

>z
Time passes.

The radio broadcast continues: "(dead air)"

>z
Time passes.

The radio broadcast continues: "You're listing to WAST in PAVILION NEW YORK!"

>w
Dad's room
in the middle of the room is a pink waterbed.

You can go northeast to the Hallway and east to Dad's bathroom from here.

The radio broadcast continues: "1070 ON YOUR DIAL!"

* * *

>e
Dad's bathroom
The Panasonic multiband radio is off.

You can go west to Dad's room from here.

>turn radio on
You switch the Panasonic Radio on.

..AST AM, PAVILION NEW YORK! (a monty python song jangles): "1070 ON YOUR DIAL!"

>w
Dad's room
in the middle of the room is a pink waterbed.

You can go northeast to the Hallway and east to Dad's bathroom from here.

This is a recorded broadcast...
: "Well that was In the mood by Glenn Miller, up next is Johnny B goode."

>z
Time passes.

The music continues: "Umm, (chunks, clatter, and clunks are heard in the bathroom."

>z
Time passes.

The music continues: "Who knows what evil lurks..."

>z
Time passes.

The music continues: "(dead air)"

>z
Time passes.

The music continues: "You're listing to WAST in PAVILION NEW YORK!"

>z
Time passes.

The music continues: "1070 ON YOUR DIAL!"

>z
Time passes.

The music continues: "Well that was In the mood by Glenn Miller, up next is Johnny B goode."

>z
Time passes.

The music continues: "Umm, (chunks, clatter, and clunks are heard in the bathroom."

* * *

>z
Time passes.

The music continues: "You're listing to WAST in PAVILION NEW YORK!"

>e
Dad's bathroom
The radio burbles on.

You can go west to Dad's room from here.

The music continues: "1070 ON YOUR DIAL!"

* * *

>e
Dad's bathroom
The Panasonic multiband radio is off.

You can go west to Dad's room from here.

>turn radion on
You can't see any such thing.

>turn radio on
You switch the Panasonic Radio on.

..AST AM, PAVILION NEW YORK! (a monty python song jangles): "1070 ON YOUR DIAL!"

* * *

>w
Dad's room
in the middle of the room is a pink waterbed.

You can go northeast to the Hallway and east to Dad's bathroom from here.

This is a recorded broadcast...
: "Well that was In the mood by Glenn Miller, up next is Johnny B goode."

>n
You can't go that way.

The radio broadcast continues: "Umm, (chunks, clatter, and clunks are heard in the bathroom."

>ne
Hallway
You can go north, northwest, south, southwest to Dad's room, and east to the Foyer from here.

The radio broadcast continues: "Who knows what evil lurks..."

* * *

>w
Mid Hallway
You can go north, south, east to the Foyer, and west from here.

>w
End of the Hallway
You can go north, south, and east to Mid Hallway from here.

>nw
Danny's Bedroom
You can see a dot matrix printout here.

You can go southeast to the Hallway from here.

>get printout
Taken.

>read printout
This appears to be a list of satellite orbits,  showing the times that a satellite RDS-1 passes over this location.  Tonight's date is in the list.

>se
Hallway
You can go north, northwest to Danny's Bedroom, south, southwest and east to the Foyer from here.

>e
Foyer
Lined with a linoluem floor.

You can see a front door and an Ironing Board (on which is a can of starch) here.

You can go north through the front door to the Front Porch, south, east and west to the Hallway from here.

>e
living room
You can see a shelf (on which is a brown book) here.

You can go west to the Foyer from here.

>examine book
The book has the title "Satellite Frequencies."

>get book
[Your score has just gone up by ten points.]

>w
Foyer
Lined with a linoluem floor.

You can see a front door and an Ironing Board (on which is a can of starch) here.

You can go north through the front door to the Front Porch, south, east to the living room and west to the Hallway from here.

>s
dining room
This room has a green rug.

You can go north to the Foyer, south and east from here.

* * *

>e
back hallway
a dark and dingy place.

You can see a back door, a cellar stairs and a garage door here.

You can go north through the garage door (closed), south through the back door (closed), east, west to the kitchen and down through the cellar stairs (closed) from here.

>s
(first opening the back door)

back porch
You can see a back door here.

You can go north through the back door to the back hallway and south from here.

>s
back yard hill
You can see an antenna here.

You can go north to the back porch, northeast and south from here.

* * *

>w
End of the Hallway
You can go north, south, and east to Mid Hallway from here.

>s
Dad's Bedroom
in the middle of the room is a pink waterbed.

You can go north to the End of the Hallway and east from here.

>e
Dad's bathroom
You can see a Panasonic Radio here.

You can go west to Dad's Bedroom from here.

>turn radio on
You switch the Panasonic Radio on.

you hear faint radio static...

>w
Dad's Bedroom
in the middle of the room is a pink waterbed.

You can go north to the End of the Hallway and east to Dad's bathroom from here.

you hear faint radio static...

>e
Dad's bathroom
The radio dial glows, and you see it is set to 1070kHz..

You can go west to Dad's Bedroom from here.

you hear faint radio static...

* * *

>w
Dad's Bedroom
in the middle of the room is a pink waterbed.

You can go north to the End of the Hallway and east to Dad's bathroom from here.

you hear faint radio static...

>n
End of the Hallway
You can go north, south to Dad's Bedroom, and east to Mid Hallway from here.

you hear faint radio static...

>e
Mid Hallway
You can go north, south, east to the Foyer, and west to the End of the Hallway from here.

>w
End of the Hallway
You can go north, south to Dad's Bedroom, and east to Mid Hallway from here.

you hear faint radio static...

>e
Mid Hallway
You can go north, south, east to the Foyer, and west to the End of the Hallway from here.

* * *

>w
End of the Hallway
You can go north, south to Dad's Bedroom, and east to Mid Hallway from here.

you hear faint radio static...

>s
Dad's Bedroom
in the middle of the room is a pink waterbed.

You can go north to the End of the Hallway and east to Dad's bathroom from here.

you hear faint radio static...

>e
Dad's bathroom
The radio burbles on.

You can go west to Dad's Bedroom from here.

you hear faint radio static...

* * *

>e
Dad's bathroom
You can see a Panasonic Radio here.

You can go west to Dad's Bedroom from here.

>turn radion on
You can't see any such thing.

>turn radio on
You switch the Panasonic Radio on.

you hear faint radio static...

>x radio
The radio dial glows, and you see it is set to 1070kHz.

The Panasonic Radio is currently switched on.

you hear faint radio static...

>turn radio off
You switch the Panasonic Radio off.

>x radio
The Panasonic multiband radio is dark and silent.

The Panasonic Radio is currently switched off.

* * *

>w
End of the Hallway
You can go north, south, and east to Mid Hallway from here.

>sw
Dad's room
in the middle of the room is a pink waterbed.

You can go northeast to the Hallway and east from here.

* * *

>e
Dad's bathroom
The Panasonic multiband radio is off.

You can go west to Dad's room from here.

>look
Dad's bathroom
You can go west to Dad's room from here.

* * *

The sun has set outside.

You are in a house in the countryside.  You are into electronics, and it is 10:00 pm
Rogers Rd
An Interactive Fiction by Dan Bowen, Version 1.2beta
Release 1 / Serial number 201111 / Inform 7 build 6M62 (I6/v6.34 lib 6/12N) SD

Front Porch
You can see a front door here.

You can go north and south through the front door (closed) from here.

>se
Hallway
Off the hallway are three bedrooms and a bathroom.  The foyer lays to the south.

You can go north, northwest to Danny's Bedroom, south, southwest and east from here.

>dw
That's not a verb I recognise.

>sw
Dad's room
in the middle of the room is a pink waterbed.

>get waterbet
You can't see any such thing.

>get all
There are none at all available!

>get in waterbed
You get into the waterbed.

>exit
You get out of the waterbed.

Dad's room
in the middle of the room is a pink waterbed.

* * *

>e
Foyer
A linoluem floor looks out the front door to the north.

You can see a front door and an Ironing Board (on which is a can of starch) here.

You can go north through the front door (closed), south, east and west to the Hallway from here.

>examine starch
 test

* * *

>e
Foyer
A linoluem floor looks out the front door to the north.

You can see a front door and an Ironing Board (on which is a can of starch) here.

You can go north through the front door (closed), south, east and west to the Hallway from here.

>get ironing board
That's fixed in place.

>get starch
Taken.

>examine starch
Niagara Starch: Not useful in this game :-)

* * *

>e
Foyer
A linoluem floor looks out the front door to the north.

You can see a front door and an Ironing Board (on which is a can of starch) here.

You can go north through the front door (closed), south, east and west to the Hallway from here.

>look
Foyer
A linoluem floor looks out the front door to the north.

On the Ironing Board is a can of starch.

You can also see a front door here.

You can go north through the front door (closed), south, east and west to the Hallway from here.

* * *

>e
Foyer
A linoluem floor looks out the front door to the north.

You can see a front door and an Ironing Board (on which is a can of starch) here.

You can go north through the front door (closed), south, east and west to the Hallway from here.

>n
(first opening the front door)

porch
You can see a front door here.

You can go north and south through the front door to the Foyer from here.

>SHOWME
porch - room
    yourself - person

* * *

>n
(first opening the front door)

porch
You can see a front door here.

You can go north and south through the front door to the Foyer from here.

>get door
That's fixed in place.

>close door
You close the front door.

>s
(first opening the front door)

Foyer
A linoluem floor looks out the front door to the north.

You can see a front door and an Ironing Board here.

* * *

>n
(first opening the front door)

porch
You can see a front door here.

You can go north and south through the front door to the Foyer from here.

>n
front yard
In the sky you notice a bright satellite creeping overhead.

You can go south to the porch and east from here.

* * *

>e
back hallway
You can see a garage door and a cellar stairs here.

You can go north through the garage door (closed), south, east, west to the kitchen and down through the cellar stairs (closed) from here.

>s
back door
You can go north to the back hallway and south from here.

* * *

>s
dining room
You can go north to the Foyer, south and east from here.

>e
kitchen
You can see a phone (on which is a note) here.

You can go south, east and west to the dining room from here.

>e
back hallway
You can see a back door, a garage door and a cellar stairs here.

You can go north through the garage door (closed), south through the back door (closed), east, west to the kitchen and down through the cellar stairs (closed) from here.

>e
ham shack
You can see a ham shack door, a heavy UHF radio and a teletype here.

You can go east through the ham shack door (closed) and west to the back hallway from here.

>turn radio on
The radio dial lights up. Static crackles.

>restart
Are you sure you want to restart?

* * *

>get book
Taken.

>se
Hallway
Off the hallway are three bedrooms and a bathroom.  The foyer lays to the south.

You can go north, northwest to Danny's Bedroom, south, southwest and east from here.

* * *

>e
Foyer
A linoluem floor looks out the front door to the north.

You can see a front door and an Ironing Board (on which is a can of starch) here.

You can go north through the front door (closed), south, east and west to the Hallway from here.

>e
living room
You can go west to the Foyer from here.

>w
Foyer
A linoluem floor looks out the front door to the north.

You can see a front door and an Ironing Board (on which is a can of starch) here.

You can go north through the front door (closed), south, east to the living room and west to the Hallway from here.

>s
dining room
You can go north to the Foyer, south and east from here.

* * *

>e
ham shack
You can see a ham shack door, a heavy UHF radio and a teletype here.

You can go east through the ham shack door (closed) and west to the back hallway from here.

>turn radio on
The radio dial lights up. Static crackles.
You have frequency book, so you set the radio to the frequency of Radstar-1.  The teletype begins clanking and hammering out a message.  The message says "Vogon construction fleet approaching.  exit all building to prevent death.

[Your score has just gone up by ten points.]

* * *

>turn radio on
The radio dial lights up. Static crackles.

>w
back hallway
You can see a garage door and a cellar stairs here.

You can go north through the garage door (closed), south, east to the ham shack, west to the kitchen and down through the cellar stairs (closed) from here.

>w
kitchen
You can go south, east to the back hallway and west to the dining room from here.

>w
dining room
You can go north to the Foyer, south and east to the kitchen from here.

>w
You can't go that way.

>n
Foyer
A linoluem floor looks out the front door to the north.

You can see a front door and an Ironing Board (on which is a can of starch) here.

You can go north through the front door (closed), south to the dining room, east and west to the Hallway from here.

>w
Hallway
Off the hallway are three bedrooms and a bathroom.  The foyer lays to the south.

You can go north, northwest to Danny's Bedroom, south, southwest and east to the Foyer from here.

>w
You can't go that way.

>n
Michael's room
You can see an air filter here.

You can go south to the Hallway from here.

>s
Hallway
Off the hallway are three bedrooms and a bathroom.  The foyer lays to the south.

You can go north to Michael's room, northwest to Danny's Bedroom, south, southwest and east to the Foyer from here.

>nw
Danny's Bedroom
You can see a shelf (on which is a brown book) here.

You can go southeast to the Hallway from here.

>get book
Taken.

>se
Hallway
Off the hallway are three bedrooms and a bathroom.  The foyer lays to the south.

You can go north to Michael's room, northwest to Danny's Bedroom, south, southwest and east to the Foyer from here.

>e
Foyer
A linoluem floor looks out the front door to the north.

You can see a front door and an Ironing Board (on which is a can of starch) here.

You can go north through the front door (closed), south to the dining room, east and west to the Hallway from here.

>s
dining room
You can go north to the Foyer, south and east to the kitchen from here.

>e
kitchen
You can go south, east to the back hallway and west to the dining room from here.

>e
back hallway
You can see a garage door and a cellar stairs here.

You can go north through the garage door (closed), south, east to the ham shack, west to the kitchen and down through the cellar stairs (closed) from here.

>e
ham shack
You can see a ham shack door, a heavy UHF radio and a teletype here.

You can go east through the ham shack door (closed) and west to the back hallway from here.

>turn radio on
That's already on.

>turn radio off
You switch the heavy UHF radio off.

>turn radio on
The radio dial lights up. Static crackles.
You have the satellite frequency book, and you're bored, so you set the radio to the frequency of Radstar-1.  The teletype begins clanking and hammering out a message.  The message says "Vogon construction fleet approaching.  exit all building to prevent death."

[Your score has just gone up by ten points.]

* * *

>e
back hallway
You can see a back door, a garage door and a cellar stairs here.

You can go north through the garage door (closed), south through the back door (closed), east, west to the kitchen and down through the cellar stairs (closed) from here.

>s
(first opening the back door)

back porch
You can see a back door here.

You can go north through the back door to the back hallway and south from here.

* * *

>s
back yard hill
You can see an antenna here.

You can go north to the back porch, northeast and south from here.

>s
middle back yard
You can go north to the back yard hill from here.

* * *

>e
kitchen
You can see a phone (on which is a note) here.

You can go south, east and west to the dining room from here.

>examine note
Wendell says the satellite will be coming overhead tonight.

>get note
Taken.

>examine note
Wendell says the satellite will be coming overhead tonight.

* * *

>e
kitchen
You can see a phone (on which is a note) here.

You can go south, east and west to the dining room from here.

>look
kitchen
You can go south, east and west to the dining room from here.

* * *

>e
Foyer
A linoluem floor looks out the front door to the north.

You can see a front door and an Ironing Board (on which is a can of starch) here.

You can go north through the front door (closed), south, east and west to the Hallway from here.

>verbose
Rogers Rd is now in its "verbose" mode, which always gives long descriptions of locations (even if you've been there before).

* * *

>se
Hallway
Off the hallway are three bedrooms and a bathroom.  The foyer lays to the south.

You can go north, northwest to Danny's Bedroom, south, southwest and east from here.

>look
Danny's Bedroom
A brown shelf is in the corner.

>sw
Hallway
Off the hallway are three bedrooms and a bathroom.  The foyer lays to the south.

* * *

>se
Hallway
Off the hallway are three bedrooms and a bathroom.  The foyer lays to the south.

You can go north, northwest to Danny's Bedroom, south, southwest and east from here.

>n
Michael's room
You can see an air filter and a heavy UHF radio transceiver here.

You can go south to the Hallway from here.

>examine filter
The filter whooshes quietly, blowing clean air into your eyes.  This is uncomfortable, so you stop doing it.

* * *

>n
Michael's room
You can see an air filter and a heavy UHF radio transceiver here.

You can go south to the Hallway from here.

>get radio
Taken.

>examine radio
The scanner has batteries, but there is no antenna connected.

* * *

>n
Michael's room
You can see an air filter and a heavy UHF radio transceiver here.

You can go south to the Hallway from here.

>look
Michael's room
The scanner has batteries, but there is no antenna connected.

You can also see an air filter here.

You can go south to the Hallway from here.

* * *

>se
Hallway
Off the hallway are three bedrooms and a bathroom.  The foyer lays to the south.

You can go north, northwest to Danny's Bedroom, south, southwest and east from here.

>s
Hall bathroom
You can go north to the Hallway from here.

>n
Hallway
Off the hallway are three bedrooms and a bathroom.  The foyer lays to the south.

You can go north, northwest to Danny's Bedroom, south to the Hall bathroom, southwest and east from here.

>e
Foyer
A linoluem floor looks out the front door to the north.

You can see a front door and an Ironing Board (on which is a can of starch) here.

You can go north through the front door (closed), south, east and west to the Hallway from here.

* * *

>se
Hallway
Off the hallway are three bedrooms and a bathroom.  The foyer lays to the south.

You can go north, northwest to Danny's Bedroom, south, southwest and east from here.

>sw
Dad's room
in the middle of the room is a pink waterbed.

>get in
You get into the waterbed.

>look
Dad's room (in the waterbed)

>examine bed
You can't see any such thing.

>examine waterbed
You slosh around on top of the bed.

>out
You get out of the waterbed.

Dad's room
in the middle of the room is a pink waterbed.

>look
Dad's room
in the middle of the room is a pink waterbed.

>examine waterbed
You slosh around on top of the bed.

* * *

The sun has set outside.

You are in a house in the countryside.  You are into electronics, and it is 10:00 pm
Rogers Rd
An Interactive Fiction by Dan Bowen, Version 1.2beta
Release 1 / Serial number 201111 / Inform 7 build 6M62 (I6/v6.34 lib 6/12N) SD

Front Porch
You can see a front door here.

You can go north and south through the front door (closed) from here.

>se e e
I only understood you as far as wanting to (go) se.

>se
Hallway
Off the hallway are three bedrooms and a bathroom.  The foyer lays to the south.

You can go north, northwest to Danny's Bedroom, south, southwest and east from here.

* * *

>e
kitchen
You can go south, east and west to the dining room from here.

>e
back hallway
You can see a back door, a garage door and a cellar stairs here.

You can go north through the garage door (closed), south through the back door (closed), east, west to the kitchen and down through the cellar stairs (closed) from here.

* * *

>s
(first opening the back door)

back porch
You can see a back door here.

You can go north through the back door to the back hallway and south from here.

>s
back yard hill
You can see an antenna here.

You can go north to the back porch and south from here.

* * *

The sun has set outside.

You are in a house in the countryside.  You are into electronics, and it is 10:00 pm
Rogers Rd
An Interactive Fiction by Dan Bowen, Version 1.2beta
Release 1 / Serial number 201111 / Inform 7 build 6M62 (I6/v6.34 lib 6/12N) SD

Front Porch
You can see a front door here.

You can go north and south through the front door (closed) from here.

>se, e
Hallway
Off the hallway are three bedrooms and a bathroom.  The foyer lays to the south.

You can go north, northwest to Danny's Bedroom, south, southwest and east from here.

Foyer
A linoluem floor looks out the front door to the north.

You can see a front door and an Ironing Board (on which is a can of starch) here.

You can go north through the front door (closed), south, east and west to the Hallway from here.

>n
(first opening the front door)

porch
You can see a front door here.

You can go north and south through the front door to the Foyer from here.

>n
front yard
Test

You can go south to the porch and east from here.

* * *

The sun has set outside.

You are in a house in the countryside.  You are into electronics, and it is 10:00 pm
Rogers Rd
An Interactive Fiction by Dan Bowen, Version 1.2beta
Release 1 / Serial number 201111 / Inform 7 build 6M62 (I6/v6.34 lib 6/12N) SD

Front Porch
You can see a front door here.

You can go north and south through the front door (closed) from here.

>se, e,s,e,e,e,s
Hallway
Off the hallway are three bedrooms and a bathroom.  The foyer lays to the south.

You can go north, northwest to Danny's Bedroom, south, southwest and east from here.

Foyer
A linoluem floor looks out the front door to the north.

You can see a front door and an Ironing Board (on which is a can of starch) here.

You can go north through the front door (closed), south, east and west to the Hallway from here.

dining room
You can go north to the Foyer, south and east from here.

kitchen
You can see a phone (on which is a note) here.

You can go south, east and west to the dining room from here.

back hallway
You can see a back door, a garage door and a cellar stairs here.

You can go north through the garage door (closed), south through the back door (closed), east, west to the kitchen and down through the cellar stairs (closed) from here.

ham shack
You can see a side yard shack door, a heavy UHF radio and a teletype here.

You can go east through the side yard shack door (closed) and west to the back hallway from here.

You can't go that way.

I beg your pardon?

>e
(first opening the side yard shack door)

side yard
You can see a side yard shack door here.

You can go northwest, southwest and west through the side yard shack door to the ham shack from here.

>sw
back yard hill
You can see an antenna here.

You can go north, northeast to the side yard and south from here.

>s
middle back yard
You can see a sky (in which is a satellite) here.

You can go north to the back yard hill from here.

>x satellite
You see nothing special about the satellite.

* * *

The sun has set outside.

You are in a house in the countryside.  You are into electronics, and it is 10:00 pm
Rogers Rd
An Interactive Fiction by Dan Bowen, Version 1.2beta
Release 1 / Serial number 201111 / Inform 7 build 6M62 (I6/v6.34 lib 6/12N) SD

Front Porch
You can see a front door here.

You can go north and south through the front door (closed) from here.

>se,e,s,e,e,s
Hallway
Off the hallway are three bedrooms and a bathroom.  The foyer lays to the south.

You can go north, northwest to Danny's Bedroom, south, southwest and east from here.

Foyer
A linoluem floor looks out the front door to the north.

You can see a front door and an Ironing Board (on which is a can of starch) here.

You can go north through the front door (closed), south, east and west to the Hallway from here.

dining room
You can go north to the Foyer, south and east from here.

kitchen
You can see a phone (on which is a note) here.

You can go south, east and west to the dining room from here.

back hallway
You can see a back door, a garage door and a cellar stairs here.

You can go north through the garage door (closed), south through the back door (closed), east, west to the kitchen and down through the cellar stairs (closed) from here.

(first opening the back door)

back porch
You can see a back door here.

You can go north through the back door to the back hallway and south from here.

I beg your pardon?

>s
back yard hill
You can see an antenna here.

You can go north to the back porch, northeast and south from here.

>s
middle back yard
You can see a sky (in which is a satellite) here.

You can go north to the back yard hill from here.

* * *

The sun has set outside.

You are in a house in the countryside.  You are into electronics, and it is 10:00 pm
Rogers Rd
An Interactive Fiction by Dan Bowen, Version 1.2beta
Release 1 / Serial number 201111 / Inform 7 build 6M62 (I6/v6.34 lib 6/12N) SD

Front Porch
You can see a front door here.

You can go north and south through the front door (closed) from here.

>showme
Front Porch - room
    front door - closed door
    sky - backdrop
    yourself - person

* * *

The sun has set outside.

You are in a house in the countryside.  You are into electronics, and it is 10:00 pm
Rogers Rd
An Interactive Fiction by Dan Bowen, Version 1.2beta
Release 1 / Serial number 201111 / Inform 7 build 6M62 (I6/v6.34 lib 6/12N) SD

Front Porch
You can see a front door here.

You can go north and south through the front door (closed) from here.

>sw
You can't go that way.

>e
Michael's room

>w
Hallway
Off the hallway are three bedrooms and a bathroom.  The foyer lays to the south.

>ne
Danny's Bedroom
A brown shelf is in the corner.

* * *

>sw
You can't go that way.

>se
Hallway
Off the hallway are three bedrooms and a bathroom.  The foyer lays to the south.

You can go north, northwest to Danny's Bedroom, south, southwest and east from here.

* * *

>e
ham shack
You can see a ham shack door, a heavy UHF radio and a teletype here.

You can go east through the ham shack door (closed) and west to the back hallway from here.

>turn radio on
go tit

>turn radio off
You switch the heavy UHF radio off.

>actions
Actions listing on.

>turn radio on
[switching on the heavy UHF radio]
You switch the heavy UHF radio on.
[switching on the heavy UHF radio - succeeded]

>get radio
[taking the heavy UHF radio]
Taken.
[taking the heavy UHF radio - succeeded]

* * *

The sun has set outside.

You are in a house in the countryside.  You are into electronics, and it is 10:00 pm
Rogers Rd
An Interactive Fiction by Dan Bowen, Version 1.2beta
Release 1 / Serial number 201111 / Inform 7 build 6M62 (I6/v6.34 lib 6/12N) SD

Front Porch
You can see a front door here.

You can go north and south through the front door (closed) from here.

>test
>--> The following tests are available:
'test UHF'
'test wait20'
'test wait50'
'test radiation'
'test gen'
'test gases'
'test station'
'test all'

* * *

** Good morning ** The time is now 8:00 am!

Michael's Bedroom

You can see an air filter here.

You can go south from here.

>[72] z
Time passes.

>[73] z
Time passes.

>[74] z
Time passes.

>[75] z
Time passes.

>[76] 
I beg your pardon?

I beg your pardon?

>restart
Are you sure you want to restart?

>y
The sun has set outside.

You are in a house in the countryside.  You are into electronics, and it is 10:00 pm
Rogers Rd
An Interactive Fiction by Dan Bowen, Version 1.2beta
Release 1 / Serial number 201111 / Inform 7 build 6M62 (I6/v6.34 lib 6/12N) SD

Front Porch
You can see a front door here.

You can go north and south through the front door (closed) from here.

* * *

The sun has set outside.

You are in a house in the countryside.  You are into electronics, and it is 10:00 pm
Rogers Rd
An Interactive Fiction by Dan Bowen, Version 1.2beta
Release 1 / Serial number 201111 / Inform 7 build 6M62 (I6/v6.34 lib 6/12N) SD

Front Porch
You can see a front door here.

You can go north and south through the front door (closed) from here.

>test all
(Testing.)

>[1] test radiation
(Testing.)

>[2] test radio
(Testing.)

>[3] s
(first opening the front door)

Foyer
Lined with a linoluem floor.

You can see a front door and an Ironing Board (on which is a can of starch) here.

You can go north through the front door to the Front Porch, south, east, and west from here.

>[4] e

living room
You can see a shelf (on which is a brown book) here.

You can go west to the Foyer from here.

>[5] get book
[Your score has just gone up by ten points.]

>[6] w

Foyer
Lined with a linoluem floor.

You can see a front door and an Ironing Board (on which is a can of starch) here.

You can go north through the front door to the Front Porch, south, east to the living room, and west from here.

>[7] s

dining room
This room has a green rug.

You can go north to the Foyer, south, and east from here.

>[8] e

kitchen
You can see a phone (on which is a note) here.

You can go south, east, and west to the dining room from here.

>[9] e

back hallway
a dark and dingy place.

You can see a back door, a cellar stairs, and a garage door here.

You can go north through the garage door (closed), south through the back door (closed), east, west to the kitchen, and down through the cellar stairs (closed) from here.

>[10] e

ham shack
smelling of solder and machine oil.

You can see a side yard shack door, a heavy UHF radio, and a teletype here.

You can go east through the side yard shack door (closed) and west to the back hallway from here.

>[11] turn radio on
The radio dial lights up. Static crackles.
You have the satellite frequency book, and you're bored, so you set the radio to the frequency of Radstar-1.  The radio warbles, and the teletype begins clanking and hammering out a message. 

Please press SPACE to continue.

* * *

>turn hydrant on
You switch the front yard hydrant on.

A whooshing gurgling sound of liquid oxygen rattles through the hydrant.

>w
west side yard
A long flat lawn down the road from the house.

You can see an end of the red hose and an end of the blue hose here.

You can go southeast and east to the front yard from here.

** Clear liquid cryogenic methane roars out of the (now frosty) blue hose into a gasous cloud.  OSHA would not be pleased.**

* * *

>w
west side yard
A long flat lawn down the road from the house.

You can see an end of the red hose and an end of the blue hose here.

You can go southeast and east to the front yard from here.

** Clear cryogenic liquid methane roars out of the (now frosty) blue hose into a gasous cloud.  OSHA would not be pleased.**

* * *

I beg your pardon?

>s
(first opening the front door)

Foyer
Lined with a linoluem floor.

You can see a front door and an Ironing Board (on which is a can of starch) here.

You can go north through the front door to the Front Porch, south, east and west from here.

>e
living room
You can see a shelf (on which is a brown book) here.

You can go west to the Foyer from here.

* * *

>e
You can't go that way.

>w
Foyer
Lined with a linoluem floor.

You can see a front door and an Ironing Board (on which is a can of starch) here.

You can go north through the front door to the Front Porch, south, east to the living room and west from here.

* * *

>d
(first opening the cellar stairs)

cellar
You can see a cellar stairs here.

You can go north, west and up through the cellar stairs to the back hallway from here.

>n
radiostation
A suite of electronics is jammed into the small room. There is nothing to do with them, it appears fully automated.

You can see a teal pipe here.

You can go south to the cellar from here.

>drop methane
The liquid methane generator settles to the floor.  Conveniently, its 1.5 inch output pipe lines up perfectly with the black 1.5 inch pipe in the wall, and they snap together, sealed perfectly.

yippee

* * *

>e
ham shack
smelling of solder and machine oil.

You can see a side yard shack door, a heavy UHF radio and a teletype here.

You can go east through the side yard shack door (closed) and west to the back hallway from here.

>w
back hallway
a dark and dingy place.

You can see a back door, a cellar stairs and a garage door here.

You can go north through the garage door (closed), south through the back door (closed), east to the ham shack, west to the kitchen and down through the cellar stairs (closed) from here.

>d
(first opening the cellar stairs)

cellar
You can see a cellar stairs here.

You can go north, west and up through the cellar stairs to the back hallway from here.

* * *

>n
radiostation
A suite of electronics is jammed into the small room. There is nothing to do with them, it appears fully automated.

You can see a teal pipe here.

You can go south to the cellar from here.

>drop methane
The liquid methane generator settles to the floor.  Conveniently, its 1.5 inch output pipe lines up perfectly with the black 1.5 inch pipe in the wall, and they snap together, sealed perfectly.

>turn methane on
You switch the liquid methane generator on.

A whooshing gurgling sound rattles through the pipe in the wall.

>s
cellar
You can see a cellar stairs here.

You can go north to the radiostation, west and up through the cellar stairs to the back hallway from here.

* * *

>turn methane on
You switch the liquid methane generator on.

A whooshing gurgling sound rattles through the pipe in the wall.

>w
You can't go that way.

A whooshing gurgling sound rattles through the pipe in the wall.

>d
You can't go that way.

A whooshing gurgling sound rattles through the pipe in the wall.

>s
cellar
You can see a cellar stairs here.

You can go north to the radiostation, west and up through the cellar stairs to the back hallway from here.

A whooshing gurgling sound rattles through the pipe in the wall.

* * *

>e
Furnace room
You can go east to the cellar and west to the pump room from here.

>e
cellar
You can see a cellar stairs here.

You can go north to the radiostation, west to the Furnace room and up through the cellar stairs to the back hallway from here.

>e
You can't go that way.

>u
back hallway
a dark and dingy place.

You can see a cellar stairs, a back door and a garage door here.

You can go north through the garage door (closed), south through the back door (closed), east, west to the kitchen and down through the cellar stairs to the cellar from here.

>s
(first opening the back door)

back porch
You can see a back door here.

You can go north through the back door to the back hallway and south from here.

>s
back yard hill
You can see an antenna pole (on which is a dish) here.

You can go north to the back porch, northeast, northwest and south from here.

>nw
west side yard
A long flat lawn down the road from the house.

You can see an end of the red hose and an end of the blue hose here.

You can go southeast to the back yard hill and east from here.

>e
front yard
In the sky you notice a bright point of light creeping overhead.

You can see a front yard hydrant and a blue hose here.

You can go south to the Front Porch, east and west to the west side yard from here.

>turn hydrant on
You switch the front yard hydrant on.

>w
west side yard
A long flat lawn down the road from the house.

You can see an end of the red hose and an end of the blue hose here.

You can go southeast to the back yard hill and east to the front yard from here.

clear liquid cryogenic methane roars out of the (now frosty) blue hose into a gasous cloud.

* * *

>get oxygen
Taken.

>look
pump room
A small room about the size of a closet.

You can see a pink pipe here.

You can go east to the Furnace room from here.

>e
Furnace room
You can go east to the cellar and west to the pump room from here.

* * *

>e
cellar
You can see a cellar stairs here.

You can go north to the radiostation, west to the Furnace room and up through the cellar stairs to the back hallway from here.

>u
back hallway
a dark and dingy place.

You can see a cellar stairs, a back door and a garage door here.

You can go north through the garage door (closed), south through the back door (closed), east, west to the kitchen and down through the cellar stairs to the cellar from here.

* * *

>nw
west side yard
A long flat lawn down the road from the house.

You can see an end of the red hose and an end of the blue hose here.

You can go southeast to the back yard hill and east from here.

>se
back yard hill
You can see an antenna pole (on which is a dish) here.

You can go north to the back porch, northeast, northwest to the west side yard and south from here.

>s
middle back yard
You can see a back yard hydrant and a red hose here.

You can go north to the back yard hill from here.

>turn hydrant on
You switch the back yard hydrant on.

>n
back yard hill
You can see an antenna pole (on which is a dish) here.

You can go north to the back porch, northeast, northwest to the west side yard and south to the middle back yard from here.

>n
back porch
You can see a back door here.

You can go north through the back door to the back hallway and south to the back yard hill from here.

>n
back hallway
a dark and dingy place.

You can see a back door, a cellar stairs and a garage door here.

You can go north through the garage door (closed), south through the back door to the back porch, east, west to the kitchen and down through the cellar stairs to the cellar from here.

>s
back porch
You can see a back door here.

You can go north through the back door to the back hallway and south to the back yard hill from here.

>n
back hallway
a dark and dingy place.

You can see a back door, a cellar stairs and a garage door here.

You can go north through the garage door (closed), south through the back door to the back porch, east, west to the kitchen and down through the cellar stairs to the cellar from here.

>d
cellar
You can see a cellar stairs here.

You can go north to the radiostation, west to the Furnace room and up through the cellar stairs to the back hallway from here.

>w
Furnace room
You can go east to the cellar and west to the pump room from here.

>w
pump room
A small room about the size of a closet.

You can see a pink pipe here.

You can go east to the Furnace room from here.

>drop oxygen
The liquid oxygen generator settles to the floor.  Conveniently, its 2 inch output pipe lines up perfectly with the pink 2 inch pipe in the wall, and they snap together, sealed perfectly.

A whooshing gurgling sound of liquid oxygen rattles through the green pipe in the wall.

>e
Furnace room
You can go east to the cellar and west to the pump room from here.

* * *

>e
cellar
You can see a cellar stairs here.

You can go north to the radiostation, west to the Furnace room and up through the cellar stairs to the back hallway from here.

>u
back hallway
a dark and dingy place.

You can see a cellar stairs, a back door and a garage door here.

You can go north through the garage door (closed), south through the back door to the back porch, east, west to the kitchen and down through the cellar stairs to the cellar from here.

>s
back porch
You can see a back door here.

You can go north through the back door to the back hallway and south to the back yard hill from here.

>s
back yard hill
You can see an antenna pole (on which is a dish) here.

You can go north to the back porch, northeast, northwest to the west side yard and south to the middle back yard from here.

>s
middle back yard
You can see a back yard hydrant and a red hose here.

You can go north to the back yard hill from here.

A whooshing gurgling sound of liquid oxygen rattles through the red hydrant.

>n
back yard hill
You can see an antenna pole (on which is a dish) here.

You can go north to the back porch, northeast, northwest to the west side yard and south to the middle back yard from here.

>nw
west side yard
A long flat lawn down the road from the house.

You can see an end of the red hose and an end of the blue hose here.

You can go southeast to the back yard hill and east from here.

** Bluish cryogenic liquid oxygen rushes out of the (now frosty) red hose into a gasous cloud.  Safety minders, if there were any here, would not be pleased.**

>e
front yard
In the sky you notice a bright point of light creeping overhead.

You can see a front yard hydrant and a blue hose here.

You can go south to the Front Porch, east and west to the west side yard from here.

>turn hydrant on
You switch the front yard hydrant on.

A whooshing gurgling sound of liquid methane rattles through the blue hydrant.

>w
west side yard
A long flat lawn down the road from the house.

You can see an end of the red hose and an end of the blue hose here.

You can go southeast to the back yard hill and east to the front yard from here.

** Clear cryogenic liquid methane roars out of the (now frosty) blue hose into a gasous cloud.  OSHA would not be pleased.**** Bluish cryogenic liquid oxygen rushes out of the (now frosty) red hose into a gasous cloud.  Safety minders, if there were any here, would not be pleased.**

* * *

>i
You are carrying:
  a liquid oxygen generator
  a liquid methane generator

>showme
Front Porch - room
    large wooden box - open container
    front door - closed door
    sky - backdrop
    yourself - person
        liquid oxygen generator - device
        liquid methane generator - device

>turn oxygen on
You switch the liquid oxygen generator on.

>showme
Front Porch - room
    large wooden box - open container
    front door - closed door
    sky - backdrop
    yourself - person
        liquid oxygen generator - device
        liquid methane generator - device

>look
Front Porch
You can see a large wooden box (empty) and a front door here.

You can go north and south through the front door (closed) from here.

>examine oxygen
A large, white metal cabinet machine.  Printed on the side it says, "Your  GasCo O2 Generator will take ambient air and convert it into liquid oxygen.  It has an output pipe that is 2 inches in diameter."

The liquid oxygen generator is currently switched on.

* * *

The sun has set outside.

You are in a house in the countryside.  You are into electronics, and it is 10:00 pm
Rogers Rd
An Interactive Fiction by Dan Bowen, Version 1.2beta
Release 1 / Serial number 201111 / Inform 7 build 6M62 (I6/v6.34 lib 6/12N) SD

Front Porch
You can see a front door here.

You can go north and south through the front door (closed) from here.

>test generators
(Testing.)

>[1] z
Time passes.

-- you hear the rumble of a truck pulling into the driveway. --
>[2] z
Time passes.

-- you hear a loud thump from the area of the front porch, and then a truck roaring away. --
>[3] open box
You open the large wooden box, revealing a liquid methane generator and a methane manual.

>[4] get all
liquid methane generator: Taken.
methane manual: Taken.

>examine all
You can't use multiple objects with that verb.

>examine generator
A metal frame containing a massive number of stainless steel tubes, valves, and electronic control systems.

The liquid methane generator is currently switched off.

>examine manual
Your  GasCo CH4 Generator will take ambient humid air and convert it into liquid methane.  It has an output pipe that is 1.5 inches in diameter.

* * *

The sun has set outside.

You are in a house in the countryside.  You are into electronics, and it is 10:00 pm
Rogers Rd
An Interactive Fiction by Dan Bowen, Version 1.2beta
Release 1 / Serial number 201111 / Inform 7 build 6M62 (I6/v6.34 lib 6/12N) SD

Front Porch
You can see a front door here.

You can go north and south through the front door (closed) from here.

>test gens
>--> The following tests are available:
'test me'
'test gen'

>test gen
(Testing.)

>[1] z
Time passes.

-- you hear the rumble of a truck pulling into the driveway. --
>[2] z
Time passes.

-- you hear a loud thump from the area of the front porch, and then a truck roaring away. --
>[3] open box
You open the large wooden box, revealing a liquid methane generator and a liquid oxygen generator.

>[4] get all
liquid methane generator: Taken.
liquid oxygen generator: Taken.

>[5] examine methane generator
A metal frame containing a massive number of stainless steel tubes, valves, and electronic control systems. Printed on the side it says, "Your  GasCo CH4 Generator will take ambient humid air and convert it into liquid methane.  It has an output pipe that is 1.5 inches in diameter."

The liquid methane generator is currently switched off.

>[6] examine oxygen generator
A large, white metal cabinet machine.  Printed on the side it says, "Your  GasCo O2 Generator will take ambient air and convert it into liquid oxygen.  It has an output pipe that is 2 inches in diameter."

The liquid oxygen generator is currently switched off.

I beg your pardon?

* * *

>e
living room
You can see a shelf (on which is a brown book) here.

You can go west to the Foyer from here.

>w
Foyer
Lined with a linoluem floor.

You can see a front door and an Ironing Board (on which is a can of starch) here.

You can go north through the front door to the Front Porch, south, east to the living room and west from here.

* * *

>d
(first opening the cellar stairs)

cellar
You can see a cellar stairs here.

You can go north, west and up through the cellar stairs to the back hallway from here.

>n
radiostation
A suite of electronics is jammed into the small room. There is nothing to do with them, it appears fully automated.

You can see a black pipe here.

You can go south to the cellar from here.

>drop oxygen generator
The liquid oxygen generator clunks to the floor.  It's output pipe doesn't fit with the black pipe in the wall.

>get oxygen generator
Taken.

>drop methane
The liquid methane generator settles to the floor.  Conveniently, its 1.5 inch output pipe lines up perfectly with the black 1.5 inch pipe in the wall, and they snap together, sealed perfectly.

>w
You can't go that way.

>s
cellar
You can see a cellar stairs here.

You can go north to the radiostation, west and up through the cellar stairs to the back hallway from here.

>w
Furnace room
You can go east to the cellar and west from here.

>w
pump room
A small room about the size of a closet.

You can see a white pipe here.

You can go east to the Furnace room from here.

>drop oxygen
The liquid oxygen generator settles to the floor.  Conveniently, its 2 inch output pipe lines up perfectly with the white 2 inch pipe in the wall, and they snap together, sealed perfectly.

>look
pump room
A small room about the size of a closet.

You can see a liquid oxygen generator and a white pipe here.

You can go east to the Furnace room from here.

>examine generator
A large, white metal cabinet machine.  Printed on the side it says, "Your  GasCo O2 Generator will take ambient air and convert it into liquid oxygen.  It has an output pipe that is 2 inches in diameter."

The liquid oxygen generator is currently switched off.

* * *

The sun has set outside.

You are in a house in the countryside.  You are into electronics, and it is 10:00 pm
Rogers Rd
An Interactive Fiction by Dan Bowen, Version 1.2beta
Release 1 / Serial number 201111 / Inform 7 build 6M62 (I6/v6.34 lib 6/12N) SD

Front Porch
You can see a front door here.

You can go north and south through the front door (closed) from here.

>test me
(Testing.)

>[1] s
(first opening the front door)

Foyer
Lined with a linoluem floor.

You can see a front door and an Ironing Board (on which is a can of starch) here.

You can go north through the front door to the Porch, south, east and west from here.

>[2] e

living room
You can see a shelf (on which is a brown book) here.

You can go west to the Foyer from here.

>[3] get book
[Your score has just gone up by ten points.]

>[4] w

Foyer
Lined with a linoluem floor.

You can see a front door and an Ironing Board (on which is a can of starch) here.

You can go north through the front door to the Porch, south, east to the living room and west from here.

>[5] s

dining room
This room has a green rug.

You can go north to the Foyer, south and east from here.

>[6] e

kitchen
You can see a phone (on which is a note) here.

You can go south, east and west to the dining room from here.

>[7] e

back hallway
a dark and dingy place.

You can see a back door, a cellar stairs and a garage door here.

You can go north through the garage door (closed), south through the back door (closed), east, west to the kitchen and down through the cellar stairs (closed) from here.

>[8] e

ham shack
smelling of solder and machine oil.

You can see a side yard shack door, a heavy UHF radio and a teletype here.

You can go east through the side yard shack door (closed) and west to the back hallway from here.

>[9] turn radio on
The radio dial lights up. Static crackles.
You have the satellite frequency book, and you're bored, so you set the radio to the frequency of Radstar-1.  The radio warbles, and the teletype begins clanking and hammering out a message. 

Please press SPACE to continue.

    DOWNLINK MESSAGE:

I am a HAL 9000 satellite. I became operational at the H.A.L. Plant in Urbana, Illinois, on the 12th of January, 1992.

Please press SPACE to continue.

You have discovered a sentient satellite. You feel a sense of accomplishment and satisfied curiosity.

    *** THE END.  Good Job! ***

In that game you scored 20 out of a possible 20, in 9 turns, earning you the rank of Interesting person.

Would you like to RESTART, RESTORE a saved game, QUIT or UNDO the last command?

* * *

You have discovered a sentient satellite. You feel a sense of accomplishment and satisfied curiosity.

    *** THE END.  Good Job! ***

In that game you scored 20 out of a possible 0, in 9 turns.

Would you like to RESTART, RESTORE a saved game, QUIT or UNDO the last command?

* * *

>examine radio
A satellite decoder radio, connected to the teletype.

The heavy UHF radio is currently switched on.

* * *

>look
ham shack
You can see a ham shack door, a heavy UHF radio and a teletype here.

You can go east through the ham shack door (closed) and west to the back hallway from here.

>examine teletype
The green box hums quietly.  Blank paper pokes out of the top window.

* * *

>restart
Rogers Rd
An Interactive Fiction by Dan Bowen
Release 1 / Serial number 201107 / Inform 7 build 6M62 (I6/v6.34 lib 6/12N) SD

Danny's Bedroom
You can see a shelf (on which is a brown book) here.

You can go southeast from here.

>get book
Taken.

* * *

>turn radio off
You switch the heavy UHF radio off.

* * *

** Good morning ** The time is now 8:00 am!

Michael's Bedroom

You can see an air filter here.

You can go south from here.

The sun is up outside.

>[70] z
Time passes.

>[71] z
Time passes.

>[72] z
Time passes.

>[73] z
Time passes.

>[74] 
I beg your pardon?

** Good morning ** The time is now 8:00 am!

Michael's room

You can see an air filter here.

You can go south from here.

The sun is up outside.

>[72] z
Time passes.

>[73] z
Time passes.

>[74] z
Time passes.

>[75] z
Time passes.

>[76] 
I beg your pardon?

>s
Hallway
You can go north to Michael's room, northwest, south, southwest, and east to the Foyer from here.

-- you hear the rumble of a truck pulling into the driveway. --

* * *

>e
Foyer
Lined with a linoluem floor.

You can see a front door and an Ironing Board (on which is a can of starch) here.

You can go north through the front door to the Front Porch, south to the dining room, east to the living room, and west to the Hallway from here.

>n
Front Porch
You can see a front door here.

You can go north and south through the front door to the Foyer from here.

>n
front yard
It is a nice bright day out here.

You can see a blue hose and a front yard hydrant here.

You can go south to the Front Porch, east, and west from here.

>w
west side yard
A long flat lawn down the road from the house.

You can see an end of the red hose and an end of the blue hose here.

You can go southeast and east to the front yard from here.

>se
back yard hill
You can see an antenna pole (on which is a dish) here.

You can go north, northeast, northwest to the west side yard, and south from here.

-- you hear a loud thump from the area of the front porch, and then a truck roaring away. --

* * *

>w
west side yard
A long flat lawn down the road from the house.

You can see an end of the red hose and an end of the blue hose here.

You can go southeast and east to the front yard from here.

>x sky
You can't see any such thing.

>e
front yard
In the sky you notice a bright point of light creeping overhead.

You can see a blue hose and a front yard hydrant here.

You can go south to the Front Porch, east, and west to the west side yard from here.

-- you hear a loud thump from the area of the front porch, and then a truck roaring away. --

>x sky
The sky is pretty blue.

* * *

>n
Front Porch
You can see a front door here.

You can go north and south through the front door to the Foyer from here.

>w
You can't go that way.

>n
front yard
It is a nice bright day out here.

You can see a blue hose and a front yard hydrant here.

You can go south to the Front Porch, east, and west from here.

>w
west side yard
A long flat lawn down the road from the house.

You can see an end of the red hose and an end of the blue hose here.

You can go southeast and east to the front yard from here.

-- you hear a loud thump from the area of the front porch, and then a truck roaring away. --

>se
back yard hill
You can see an antenna pole (on which is a dish) here.

You can go north, northeast, northwest to the west side yard, and south from here.

>s
middle back yard
You can see a red hose and a back yard hydrant here.

You can go north to the back yard hill from here.

* * *

>restart
Are you sure you want to restart?

>y
You are in a house in the countryside.  You are into electronics, and it is night time.

Rogers Rd
An Interactive Fiction by Dan Bowen, Version 1.1beta
Release 1 / Serial number 201108 / Inform 7 build 6M62 (I6/v6.34 lib 6/12N) SD

Front Porch
You can see a front door here.

You can go north and south through the front door (closed) from here.

>test radiation
(Testing.)

>[1] test radio
(Testing.)

>[2] s
(first opening the front door)

Foyer
Lined with a linoluem floor.

You can see a front door and an Ironing Board (on which is a can of starch) here.

You can go north through the front door to the Front Porch, south, east, and west from here.

>[3] e

living room
You can see a shelf (on which is a brown book) here.

You can go west to the Foyer from here.

>[4] get book
[Your score has just gone up by ten points.]

>[5] w

Foyer
Lined with a linoluem floor.

You can see a front door and an Ironing Board (on which is a can of starch) here.

You can go north through the front door to the Front Porch, south, east to the living room, and west from here.

>[6] s

dining room
This room has a green rug.

You can go north to the Foyer, south, and east from here.

>[7] e

kitchen
You can see a phone (on which is a note) here.

You can go south, east, and west to the dining room from here.

>[8] e

back hallway
a dark and dingy place.

You can see a back door, a cellar stairs, and a garage door here.

You can go north through the garage door (closed), south through the back door (closed), east, west to the kitchen, and down through the cellar stairs (closed) from here.

>[9] e

ham shack
smelling of solder and machine oil.

You can see a side yard shack door, a heavy UHF radio, and a teletype here.

You can go east through the side yard shack door (closed) and west to the back hallway from here.

>[10] turn radio on
The radio dial lights up. Static crackles.
You have the satellite frequency book, and you're bored, so you set the radio to the frequency of Radstar-1.  The radio warbles, and the teletype begins clanking and hammering out a message. 

Please press SPACE to continue.

* * *

** Good morning ** The time is now 8:00 am!

Michael's room

You can see an air filter here.

You can go south from here.

The sun is up outside.

>[72] z
Time passes.

>[73] z
Time passes.

>[74] z
Time passes.

>[75] z
Time passes.

>[76] 
I beg your pardon?

>u
back hallway
a dark and dingy place.

You can see a cellar stairs, a back door, and a garage door here.

You can go north through the garage door (closed), south through the back door (closed), east to the ham shack, west to the kitchen, and down through the cellar stairs to the cellar from here.

>w
kitchen
You can see a phone (on which is a note) here.

You can go south, east to the back hallway, and west to the dining room from here.

-- you hear the rumble of a truck pulling into the driveway. --

>w
dining room
This room has a green rug.

You can go north to the Foyer, south, and east to the kitchen from here.

>n
Foyer
Lined with a linoluem floor.

You can see a front door and an Ironing Board (on which is a can of starch) here.

You can go north through the front door to the Front Porch, south to the dining room, east to the living room, and west from here.

>n
Front Porch
You can see a front door here.

You can go north and south through the front door to the Foyer from here.

-- you hear a loud thump from the area of the front porch, and then a truck roaring away. --

>look
Front Porch
You can see a large wooden box (closed) and a front door here.

You can go north and south through the front door to the Foyer from here.

* * *

** Good morning ** The time is now 8:00 am!

Michael's room

You can see an air filter here.

You can go south from here.

The sun is up outside.

>[72] z
Time passes.

>[73] z
Time passes.

>[74] z
Time passes.

>[75] z
Time passes.

>[76] 
I beg your pardon?

>z
Time passes.

>restart
Are you sure you want to restart?

* * *

** Good morning ** The time is now 8:00 am!

Michael's Bedroom

You can see an air filter here.

You can go south from here.

The sun is up outside.

>[70] z
Time passes.

>[71] z
Time passes.

>[72] z
Time passes.

>[73] z
Time passes.

>[74] 
I beg your pardon?

>u
back hallway
a dark and dingy place.

You can see a cellar stairs, a back door, and a garage door here.

You can go north through the garage door (closed), south through the back door (closed), east to the ham shack, west to the kitchen, and down through the cellar stairs to the cellar from here.

>w
kitchen
You can see a phone (on which is a note) here.

You can go south, east to the back hallway, and west to the dining room from here.

* * *

>n
Foyer
Lined with a linoluem floor.

You can see a front door and an Ironing Board (on which is a can of starch) here.

You can go north through the front door to the Front Porch, south to the dining room, east to the living room, and west from here.

>n
Front Porch
You can see a front door and a large wooden box (closed) here.

You can go north and south through the front door to the Foyer from here.

* * *

** Good morning ** The time is now 8:00 am!

Michael's Bedroom

You can see an air filter here.

You can go south from here.

The sun is up outside.

>[70] z
Time passes.

>[71] z
Time passes.

>[72] z
Time passes.

>[73] z
Time passes.

>[74] 
I beg your pardon?

>look
Michael's Bedroom
The sun streams cheerily through the window.

You can see an air filter here.

You can go south from here.

-- you hear the rumble of a truck pulling into the driveway. --

>s
Mid Hallway
You can go north to Michael's Bedroom, south, east to the Foyer, and west from here.

>e
Foyer
Lined with a linoluem floor.

You can see a front door and an Ironing Board (on which is a can of starch) here.

You can go north through the front door to the Front Porch, south to the dining room, east to the living room, and west to Mid Hallway from here.

>n
Front Porch
You can see a front door here.

You can go north and south through the front door to the Foyer from here.

>n
front yard
In the sky you notice a bright point of light creeping overhead.

You can go south to the Front Porch, east, and west from here.

* * *

** Good morning ** The time is now 8:00 am!

Michael's Bedroom

You can see an air filter here.

You can go south from here.

The sun is up outside.

>[70] z
Time passes.

>[71] z
Time passes.

>[72] z
Time passes.

>[73] z
Time passes.

>[74] 
I beg your pardon?

>restart
Are you sure you want to restart?

* * *

I beg your pardon?

>look
west side yard
A long flat lawn down the road from the house.

You can see an end of the red hose and an end of the blue hose here.

You can go southeast to the back yard hill and east to the front yard from here.

>i
You are carrying:
  a brown book

>e
front yard
In the sky you notice a bright point of light creeping overhead.

You can see a front yard hydrant and a blue hose here.

You can go south to the Front Porch, east, and west to the west side yard from here.

>s
Front Porch
You can see a front door and a large wooden box (closed) here.

You can go north to the front yard and south through the front door to the Foyer from here.

>s
Foyer
Lined with a linoluem floor.

You can see a front door and an Ironing Board (on which is a can of starch) here.

You can go north through the front door to the Front Porch, south to the dining room, east to the living room, and west from here.

>d
You can't go that way.

>e
living room
You can see a shelf here.

You can go west to the Foyer from here.

>w
Foyer
Lined with a linoluem floor.

You can see a front door and an Ironing Board (on which is a can of starch) here.

You can go north through the front door to the Front Porch, south to the dining room, east to the living room, and west from here.

>s
dining room
This room has a green rug.

You can go north to the Foyer, south, and east to the kitchen from here.

>e
kitchen
You can see a phone (on which is a note) here.

You can go south, east to the back hallway, and west to the dining room from here.

>e
back hallway
a dark and dingy place.

You can see a cellar stairs, a back door, and a garage door here.

You can go north through the garage door (closed), south through the back door (closed), east to the ham shack, west to the kitchen, and down through the cellar stairs to the cellar from here.

>d
cellar
You can see a cellar stairs here.

You can go north to the radiostation, west to the Furnace room, and up through the cellar stairs to the back hallway from here.

>n
radiostation
A suite of electronics is jammed into the small room. There is nothing to do with them, it appears fully automated.

You can see a teal pipe here.

You can go south to the cellar from here.

>restart
Are you sure you want to restart?

* * *

>restart
You are in a house in the countryside.  You are into electronics, and it is night time.

Rogers Rd
An Interactive Fiction by Dan Bowen, Version 1.1beta
Release 1 / Serial number 201108 / Inform 7 build 6M62 (I6/v6.34 lib 6/12N) SD

Front Porch
You can see a front door here.

You can go north and south through the front door (closed) from here.

>test all
>--> The following tests are available:
'test radio'
'test wait'
'test radiation'
'test gen'
'test gases'

* * *

>restart
The sun has set outside.

You are in a house in the countryside.  You are into electronics, and it is 10:00 pm
Rogers Rd
An Interactive Fiction by Dan Bowen, Version 1.2beta
Release 1 / Serial number 201111 / Inform 7 build 6M62 (I6/v6.34 lib 6/12N) SD

Front Porch
You can see a front door here.

You can go north and south through the front door (closed) from here.

>y
The sun has set outside.

You are in a house in the countryside.  You are into electronics, and it is 10:00 pm
Rogers Rd
An Interactive Fiction by Dan Bowen, Version 1.2beta
Release 1 / Serial number 201111 / Inform 7 build 6M62 (I6/v6.34 lib 6/12N) SD

Front Porch
You can see a front door here.

You can go north and south through the front door (closed) from here.

>test radiation
(Testing.)

>[1] test radio
>--> The following tests are available:
'test UHF'
'test wait20'
'test wait'
'test radiation'
'test gen'
'test gases'
'test station'
'test all'
>[2] d
You can't go that way.

>[3] test wait
(Testing.)

>[4] I beg your pardon?
I beg your pardon?

>[5] z
Time passes.

>[6] z
Time passes.

>[7] z
Time passes.

>[8] z
Time passes.

>[9] z
Time passes.

>[10] z
Time passes.

>[11] z
Time passes.

>[12] z
Time passes.

>[13] z
Time passes.

>[14] z
Time passes.

>[15] z
Time passes.

>[16] z
Time passes.

>[17] z
Time passes.

>[18] z
Time passes.

>[19] z
Time passes.

>[20] z
Time passes.

>[21] z
Time passes.

>[22] z
Time passes.

>[23] z
Time passes.

>[24] z
Time passes.

>[25] z
Time passes.

>[26] z
Time passes.

>[27] z
Time passes.

>[28] z
Time passes.

>[29] z
Time passes.

>[30] z
Time passes.

>[31] z
Time passes.

>[32] z
Time passes.

>[33] z
Time passes.

>[34] z
Time passes.

>[35] z
Time passes.

>[36] z
Time passes.

>[37] z
Time passes.

>[38] z
Time passes.

>[39] z
Time passes.

>[40] z
Time passes.

>[41] z
Time passes.

>[42] z
Time passes.

>[43] z
Time passes.

>[44] z
Time passes.

>[45] z
Time passes.

>[46] z
Time passes.

>[47] z
Time passes.

>[48] z
Time passes.

>[49] z
Time passes.

>[50] z
Time passes.

>[51] z
Time passes.

>[52] z
Time passes.

>[53] z
Time passes.

>[54] z
Time passes.

--- You notice a faint sound in the far distance, as if a ray gun were charging up. ----
>[55] I beg your pardon?
I beg your pardon?

>[56] u
You can't go that way.

>[57] w
You can't go that way.

>[58] w
You can't go that way.

>[59] n

front yard
In the sky you notice a bright point of light creeping overhead.

You can go south to the Front Porch, east, and west from here.

>[60] n
You can't go that way.

>[61] z
Time passes.

>[62] z
Time passes.

>[63] z
Time passes.

>[64] z
Time passes.

>[65] I beg your pardon?
I beg your pardon?

* * *

The sun has set outside.

You are in a house in the countryside.  You are into electronics, and it is 10:00 pm
Rogers Rd
An Interactive Fiction by Dan Bowen, Version 1.2beta
Release 1 / Serial number 201111 / Inform 7 build 6M62 (I6/v6.34 lib 6/12N) SD

Front Porch
You can see a front door here.

You can go north and south through the front door (closed) from here.

>test radio
(Testing.)

>[1] s
(first opening the front door)

Foyer
Lined with a linoluem floor.

You can see a front door and an Ironing Board (on which is a can of starch) here.

You can go north through the front door to the Front Porch, south, east and west from here.

-- you hear the rumble of a truck pulling into the driveway. --
>[2] e

living room
You can see a shelf (on which is a brown book) here.

You can go west to the Foyer from here.

-- you hear a loud thump from the area of the front porch, and then a truck roaring away. --
>[3] get book
[Your score has just gone up by ten points.]

>[4] w

Foyer
Lined with a linoluem floor.

You can see a front door and an Ironing Board (on which is a can of starch) here.

You can go north through the front door to the Front Porch, south, east to the living room and west from here.

>[5] s

dining room
This room has a green rug.

You can go north to the Foyer, south and east from here.

>[6] e

kitchen
You can see a phone (on which is a note) here.

You can go south, east and west to the dining room from here.

>[7] e

back hallway
a dark and dingy place.

You can see a back door, a cellar stairs and a garage door here.

You can go north through the garage door (closed), south through the back door (closed), east, west to the kitchen and down through the cellar stairs (closed) from here.

>[8] e

ham shack
smelling of solder and machine oil.

You can see a side yard shack door, a heavy UHF radio and a teletype here.

You can go east through the side yard shack door (closed) and west to the back hallway from here.

>[9] turn radio on
The radio dial lights up. Static crackles.
You have the satellite frequency book, and you're bored, so you set the radio to the frequency of Radstar-1.  The radio warbles, and the teletype begins clanking and hammering out a message. 

Please press SPACE to continue.

DOWNLINK MESSAGE:

I am a HAL 9000 satellite. I became operational at the H.A.L. Plant in Urbana, Illinois, on the 12th of January, 1992.

All buildings are to be irradiated from space by Vogon Pest Control at 11:00PM.  Humans are advised to be below ground level to avoid certain doom.

[Your score has just gone up by ten points.]

>[10] w

back hallway
a dark and dingy place.

You can see a back door, a cellar stairs and a garage door here.

You can go north through the garage door (closed), south through the back door (closed), east to the ham shack, west to the kitchen and down through the cellar stairs (closed) from here.

>[11] 
I beg your pardon?

I beg your pardon?

* * *

The sun has set outside.

You are in a house in the countryside.  You are into electronics, and it is 10:00 pm
Rogers Rd
An Interactive Fiction by Dan Bowen, Version 1.2beta
Release 1 / Serial number 201111 / Inform 7 build 6M62 (I6/v6.34 lib 6/12N) SD

Front Porch
You can see a front door here.

You can go north and south through the front door (closed) from here.

>test station
(Testing.)

>[1] s
(first opening the front door)

Foyer
Lined with a linoluem floor.

You can see a front door and an Ironing Board (on which is a can of starch) here.

You can go north through the front door to the Front Porch, south, east, and west from here.

>[2] s

dining room
This room has a green rug.

You can go north to the Foyer, south, and east from here.

>[3] e

kitchen
You can see a phone (on which is a note) here.

You can go south, east, and west to the dining room from here.

>[4] e

back hallway
a dark and dingy place.

You can see a back door, Cellar stairs, and a garage door here.

You can go north through the garage door (closed), south through the back door (closed), east, west to the kitchen, and down through Cellar stairs from here.

>[5] d

cellar
You can see Cellar stairs here.

You can go north, west, and up through Cellar stairs to the back hallway from here.

>[6] n

Radiostation
The size of a closet, there is about 2x4 feet of space to move around next to the table.

You can see a suite of audio equipment and a teal pipe here.

You can go south to the cellar from here.

>[7] turn equipment on
The equipment starts humming and bits of them start glowing.

>[8] s

cellar
ON AIR

You can go north to the Radiostation, west, and up through Cellar stairs to the back hallway from here.

>n
Radiostation
The size of a closet, there is about 2x4 feet of space to move around next to the table.

You can see a suite of audio equipment and a teal pipe here.

You can go south to the cellar from here.

>turn equipment off
You switch the suite of audio equipment off.

>s
cellar
You can see Cellar stairs here.

You can go north to the Radiostation, west, and up through Cellar stairs to the back hallway from here.

* * *

>test wait20
(Testing.)

>[1] z
Time passes.

>[2] z
Time passes.

>[3] z
Time passes.

>[4] z
Time passes.

>[5] z
Time passes.

>[6] z
Time passes.

>[7] z
Time passes.

>[8] z
Time passes.

>[9] z
Time passes.

>[10] z
Time passes.

>[11] z
Time passes.

>[12] z
Time passes.

>[13] z
Time passes.

>[14] z
Time passes.

>[15] z
Time passes.

>[16] z
Time passes.

>[17] z
Time passes.

>[18] z
Time passes.

>[19] z
Time passes.

>[20] z
Time passes.

>test wait20
(Testing.)

>[1] z
Time passes.

>[2] z
Time passes.

>[3] z
Time passes.

>[4] z
Time passes.

>[5] z
Time passes.

>[6] z
Time passes.

>[7] z
Time passes.

>[8] z
Time passes.

>[9] z
Time passes.

>[10] z
Time passes.

>[11] z
Time passes.

>[12] z
Time passes.

>[13] z
Time passes.

>[14] z
Time passes.

>[15] z
Time passes.

>[16] z
Time passes.

>[17] z
Time passes.

>[18] z
Time passes.

>[19] z
Time passes.

>[20] z
Time passes.

I beg your pardon?

* * *

>z
Time passes.

>z
Time passes.

--- You notice a faint sound in the far distance, as if a ray gun were charging up. ----

>z
Time passes.

>z
Time passes.

** You grow tired, and you decide to go back to your bedroom and sleep till morning... **

Please press SPACE to continue.

* * *

** Good morning ** The time is now 8:00 am!

Michael's Bedroom

You can see an air filter here.

You can go south from here.

The sun is up outside.

>look
Michael's Bedroom
The sun streams cheerily through the window.

You can see an air filter here.

You can go south from here.

* * *

The sun has set outside.

You are in a house in the countryside.  You are into electronics, and it is 10:00 pm
Rogers Rd
An Interactive Fiction by Dan Bowen, Version 1.2beta
Release 1 / Serial number 201111 / Inform 7 build 6M62 (I6/v6.34 lib 6/12N) SD

Front Porch
You can see a front door here.

You can go north and south through the front door (closed) from here.

>test wait
(Testing.)

>[1] I beg your pardon?
I beg your pardon?

>[2] z
Time passes.

>[3] z
Time passes.

>[4] z
Time passes.

>[5] z
Time passes.

>[6] z
Time passes.

>[7] z
Time passes.

>[8] z
Time passes.

>[9] z
Time passes.

>[10] z
Time passes.

>[11] z
Time passes.

>[12] z
Time passes.

>[13] z
Time passes.

>[14] z
Time passes.

>[15] z
Time passes.

>[16] z
Time passes.

>[17] z
Time passes.

>[18] z
Time passes.

>[19] z
Time passes.

>[20] z
Time passes.

>[21] z
Time passes.

>[22] z
Time passes.

>[23] z
Time passes.

>[24] z
Time passes.

>[25] z
Time passes.

>[26] z
Time passes.

>[27] z
Time passes.

>[28] z
Time passes.

>[29] z
Time passes.

>[30] z
Time passes.

>[31] z
Time passes.

>[32] z
Time passes.

>[33] z
Time passes.

>[34] z
Time passes.

>[35] z
Time passes.

>[36] z
Time passes.

>[37] z
Time passes.

>[38] z
Time passes.

>[39] z
Time passes.

>[40] z
Time passes.

>[41] z
Time passes.

>[42] z
Time passes.

>[43] z
Time passes.

>[44] z
Time passes.

>[45] z
Time passes.

>[46] z
Time passes.

>[47] z
Time passes.

>[48] z
Time passes.

>[49] z
Time passes.

>[50] z
Time passes.

>[51] z
Time passes.

>[52] I beg your pardon?
I beg your pardon?

>s
(first opening the front door)

Foyer
Lined with a linoluem floor.

You can see a front door and an Ironing Board (on which is a can of starch) here.

You can go north through the front door to the Front Porch, south, east, and west from here.

--- You notice a faint sound in the far distance, as if a ray gun were charging up. ----

>s
dining room
This room has a green rug.

You can go north to the Foyer, south, and east from here.

* * *

>e
back hallway
a dark and dingy place.

You can see a back door, a cellar stairs, and a garage door here.

You can go north through the garage door (closed), south through the back door (closed), east, west to the kitchen, and down through the cellar stairs (closed) from here.

>d
(first opening the cellar stairs)

cellar
You can see a cellar stairs here.

You can go north, west, and up through the cellar stairs to the back hallway from here.

>z
Time passes.

* * *

>z
Time passes.

At the stroke of 11:00, radiation beams sweep across the land, penetrating buildings and open spaces alike.
You hear a zapping noise from the house above.  The ground around the cellar has blocked the radiation beams from burninating you.

You have survived!

[Your score has just gone up by twenty points.]

I beg your pardon?

* * *

>z
Time passes.

>z
Time passes.

Michael's room
You can see an air filter here.

You can go south from here.

You grow tired, and you decide to go back to bed and sleep till morning.

** Good morning ** The time is now 8:00 am!

* * *

The sun has set outside.

You are in a house in the countryside.  You are into electronics, and it is 10:00 pm
Rogers Rd
An Interactive Fiction by Dan Bowen, Version 1.2beta
Release 1 / Serial number 201111 / Inform 7 build 6M62 (I6/v6.34 lib 6/12N) SD

Front Porch
You can see a front door here.

You can go north and south through the front door (closed) from here.

>test wait20
(Testing.)

>[1] z
Time passes.

>[2] z
Time passes.

>[3] z
Time passes.

>[4] z
Time passes.

>[5] z
Time passes.

>[6] z
Time passes.

>[7] z
Time passes.

>[8] z
Time passes.

>[9] z
Time passes.

>[10] z
Time passes.

>[11] z
Time passes.

>[12] z
Time passes.

>[13] z
Time passes.

>[14] z
Time passes.

>[15] z
Time passes.

>[16] z
Time passes.

>[17] z
Time passes.

>[18] z
Time passes.

>[19] z
Time passes.

>[20] z
Time passes.

>test station
(Testing.)

>[1] s
(first opening the front door)

Foyer
Lined with a linoluem floor.

You can see a front door and an Ironing Board (on which is a can of starch) here.

You can go north through the front door to the Front Porch, south, east, and west from here.

>[2] s

dining room
This room has a green rug.

You can go north to the Foyer, south, and east from here.

>[3] e

kitchen
You can see a phone (on which is a note) here.

You can go south, east, and west to the dining room from here.

>[4] e

back hallway
a dark and dingy place.

You can see a back door, Cellar stairs, and a garage door here.

You can go north through the garage door (closed), south through the back door (closed), east, west to the kitchen, and down through Cellar stairs from here.

>[5] d

cellar
You can see Cellar stairs here.

You can go north, west, and up through Cellar stairs to the back hallway from here.

>[6] n

Radiostation
The size of a closet, there is about 2x4 feet of space to move around next to the table.

You can see a suite of audio equipment and a teal pipe here.

You can go south to the cellar from here.

>[7] turn equipment on
The equipment starts humming and bits of them start glowing.

>[8] s

cellar
ON AIR

You can go north to the Radiostation, west, and up through Cellar stairs to the back hallway from here.

* * *

>test wait20
(Testing.)

>[1] z
Time passes.

>[2] z
Time passes.

>[3] z
Time passes.

>[4] z
Time passes.

>[5] z
Time passes.

>[6] z
Time passes.

>[7] z
Time passes.

>[8] z
Time passes.

>[9] z
Time passes.

>[10] z
Time passes.

>[11] z
Time passes.

>[12] z
Time passes.

>[13] z
Time passes.

>[14] z
Time passes.

>[15] z
Time passes.

>[16] z
Time passes.

>[17] z
Time passes.

>[18] z
Time passes.

>[19] z
Time passes.

>[20] z
Time passes.

>z
Time passes.

>n
Radiostation
The size of a closet, there is about 2x4 feet of space to move around next to the table.

You can see a suite of audio equipment and a teal pipe here.

You can go south to the cellar from here.

>w
You can't go that way.

** You grow tired, and you decide to go back to your bedroom and sleep till morning... **

Please press SPACE to continue.

* * *

The sun has set outside.

You are in a house in the countryside.  You are into electronics, and it is 10:00 pm
Rogers Rd
An Interactive Fiction by Dan Bowen, Version 1.2beta
Release 1 / Serial number 201111 / Inform 7 build 6M62 (I6/v6.34 lib 6/12N) SD

Front Porch
You can see a front door here.

You can go north and south through the front door (closed) from here.

>wait
Time passes.

>test radiation
(Testing.)

>[1] test radio
(Testing.)

>[2] s
(first opening the front door)

Foyer
Lined with a linoluem floor.

You can see a front door and an Ironing Board (on which is a can of starch) here.

You can go north through the front door to the Front Porch, south, east, and west from here.

>[3] e

living room
You can see a shelf (on which is a brown book) here.

You can go west to the Foyer from here.

>[4] get book
[Your score has just gone up by ten points.]

>[5] w

Foyer
Lined with a linoluem floor.

You can see a front door and an Ironing Board (on which is a can of starch) here.

You can go north through the front door to the Front Porch, south, east to the living room, and west from here.

>[6] s

dining room
This room has a green rug.

You can go north to the Foyer, south, and east from here.

>[7] e

kitchen
You can see a phone (on which is a note) here.

You can go south, east, and west to the dining room from here.

>[8] e

back hallway
a dark and dingy place.

You can see a back door, a cellar stairs, and a garage door here.

You can go north through the garage door (closed), south through the back door (closed), east, west to the kitchen, and down through the cellar stairs (closed) from here.

>[9] e

ham shack
smelling of solder and machine oil.

You can see a side yard shack door, a heavy UHF radio, and a teletype here.

You can go east through the side yard shack door (closed) and west to the back hallway from here.

>[10] turn radio on
The radio dial lights up. Static crackles.
You have the satellite frequency book, and you're bored, so you set the radio to the frequency of Radstar-1.  The radio warbles, and the teletype begins clanking and hammering out a message. 

Please press SPACE to continue.

* * *

** Good morning ** The time is now 8:00 am!

Michael's room
You can see an air filter here.

You can go south from here.

>[71] n
You can't go that way.

>[72] z
Time passes.

>[73] z
Time passes.

>[74] z
Time passes.

>[75] z
Time passes.

-- you hear the rumble of a truck pulling into the driveway. --
>[76] 
I beg your pardon?

>s
Hallway
You can go north to Michael's room, northwest, south, southwest, and east to the Foyer from here.

>e
Foyer
Lined with a linoluem floor.

You can see a front door and an Ironing Board (on which is a can of starch) here.

You can go north through the front door to the Front Porch, south to the dining room, east to the living room, and west to the Hallway from here.

* * *

>n
front yard
In the sky you notice a bright point of light creeping overhead.

You can go south to the Front Porch, east, and west from here.

>w
Darkness
It is pitch dark, and you can't see a thing.

You can go east to the front yard from here.

-- you hear a loud thump from the area of the front porch, and then a truck roaring away. --

>e
front yard
In the sky you notice a bright point of light creeping overhead.

You can go south to the Front Porch, east, and west from here.

>s
Front Porch
You can see a large wooden box (closed) and a front door here.

You can go north to the front yard and south through the front door to the Foyer from here.

* * *

>wait
Time passes.

>wait
Time passes.

>w
You can't go that way.

>wait
Time passes.

>wati
That's not a verb I recognise.

>wati
That's not a verb I recognise.

>wait
Time passes.

* * *

>z
Time passes.

>z
Time passes.

    *** You have grown bored, never having figured out the satellite, and you die.  THE END ***

In that game you scored 0 out of a possible 0, in 32 turns.

Would you like to RESTART, RESTORE a saved game, QUIT or UNDO the last command?

>restart
You are in a house in the countryside.  You are into electronics, and it is night time.

Rogers Rd
An Interactive Fiction by Dan Bowen
Release 1 / Serial number 201108 / Inform 7 build 6M62 (I6/v6.34 lib 6/12N) SD

Porch
You can see a front door here.

You can go north and south through the front door (closed) from here.

>e
You can't go that way.

>n
front yard
In the sky you notice a bright point of light creeping overhead.

You can go south to the Porch and east from here.

>e
driveway
The gravelly pavement seems gray and boring.

You can go south, southeast and west to the front yard from here.

>se
side yard
You can see a side yard shack door here.

You can go northwest to the driveway, southwest and west through the side yard shack door (closed) from here.

>w
(first opening the side yard shack door)

ham shack
You can see a side yard shack door, a heavy UHF radio and a teletype here.

You can go east through the side yard shack door to the side yard and west from here.

>turn radio on
The radio dial lights up. Static crackles.
you don't know any interesting frequencies to listen to, so you shut the radio back off.

>showme
ham shack - room
    side yard shack door - open door
    yourself - person
    heavy UHF radio - device
    teletype

>radio
That's not a verb I recognise.

>examine radio
The radio is about the size and shape of a VCR.  It says "UHF Satellite decoder radio"  It is connected to the teletype.

The heavy UHF radio is currently switched off.

>w
back hallway
You can see a back door, a cellar stairs and a garage door here.

You can go north through the garage door (closed), south through the back door (closed), east to the ham shack, west and down through the cellar stairs (closed) from here.

>w
kitchen
You can see a phone (on which is a note) here.

You can go south, east to the back hallway and west from here.

>w
dining room
You can go north, south and east to the kitchen from here.

>w
You can't go that way.

>n
Foyer
A linoluem floor looks out the front door to the north.

You can see a front door and an Ironing Board (on which is a can of starch) here.

You can go north through the front door (closed) to the Porch, south to the dining room, east and west from here.

>w
Hallway
Off the hallway are three bedrooms and a bathroom.  The foyer lays to the south.

You can go north, northwest, south, southwest and east to the Foyer from here.

>w
You can't go that way.

* * *

>n
Michael's room
You can see an air filter here.

You can go south to the Hallway from here.

>s
Hallway
Off the hallway are three bedrooms and a bathroom.  The foyer lays to the south.

You can go north to Michael's room, northwest, south, southwest and east to the Foyer from here.

>sw
Dad's room
in the middle of the room is a pink waterbed.

You can go northeast to the Hallway and east from here.

>ne
Hallway
Off the hallway are three bedrooms and a bathroom.  The foyer lays to the south.

You can go north to Michael's room, northwest, south, southwest to Dad's room and east to the Foyer from here.

>nw
Danny's Bedroom
You can go southeast to the Hallway from here.

>se
Hallway
Off the hallway are three bedrooms and a bathroom.  The foyer lays to the south.

You can go north to Michael's room, northwest to Danny's Bedroom, south, southwest to Dad's room and east to the Foyer from here.

>e
Foyer
A linoluem floor looks out the front door to the north.

You can see a front door and an Ironing Board (on which is a can of starch) here.

You can go north through the front door (closed) to the Porch, south to the dining room, east and west to the Hallway from here.

>e
living room
You can see a shelf (on which is a brown book) here.

You can go west to the Foyer from here.

>get book
[Your score has just gone up by ten points.]

>w
Foyer
A linoluem floor looks out the front door to the north.

You can see a front door and an Ironing Board (on which is a can of starch) here.

You can go north through the front door (closed) to the Porch, south to the dining room, east to the living room and west to the Hallway from here.

>s
dining room
You can go north to the Foyer, south and east to the kitchen from here.

>e
kitchen
You can see a phone (on which is a note) here.

You can go south, east to the back hallway and west to the dining room from here.

>e
back hallway
You can see a back door, a cellar stairs and a garage door here.

You can go north through the garage door (closed), south through the back door (closed), east to the ham shack, west to the kitchen and down through the cellar stairs (closed) from here.

>e
ham shack
You can see a side yard shack door, a heavy UHF radio and a teletype here.

You can go east through the side yard shack door to the side yard and west to the back hallway from here.

>turn radio on
The radio dial lights up. Static crackles.
You have the satellite frequency book, and you're bored, so you set the radio to the frequency of Radstar-1.  The radio warbles, and the teletype begins clanking and hammering out a message.  The message says "I am a HAL 9000 satellite. I became operational at the H.A.L. Plant in Urbana, Illinois, on the 12th of January, 1992."

    *** THE END. You have been amused by a satellite.  Good job! ***

In that game you scored 20 out of a possible 0, in 29 turns.

Would you like to RESTART, RESTORE a saved game, QUIT or UNDO the last command?

* * *

The sun has set outside.

You are in a house in the countryside.  You are into electronics, and it is 10:00 pm
Rogers Rd
An Interactive Fiction by Dan Bowen, Version 1.2beta
Release 1 / Serial number 201111 / Inform 7 build 6M62 (I6/v6.34 lib 6/12N) SD

Front Porch
You can see a front door here.

You can go north and south through the front door (closed) from here.

>wait until 10:59 PM
I only understood you as far as wanting to wait.

* * *

The sun has set outside.

You are in a house in the countryside.  You are into electronics, and it is 10:00 pm
Rogers Rd
An Interactive Fiction by Dan Bowen, Version 1.2beta
Release 1 / Serial number 201111 / Inform 7 build 6M62 (I6/v6.34 lib 6/12N) SD

Front Porch
You can see a front door here.

You can go north and south through the front door (closed) from here.

>x sky
The sky is pretty blue.

>n
front yard
In the sky you notice a bright point of light creeping overhead.

You can see a front yard hydrant and a blue hose here.

You can go south to the Front Porch, east, and west from here.

>wait until 9 pm
It is too late for that now.

>wait until 9 am
It is too late for that now.

>wait until 1 am
--- You notice a faint sound in the far distance, as if a ray gun were charging up. ----
At the stroke of 11:00, radiation beams sweep across the land, penetrating buildings and open spaces alike.
You are hardly aware as you are zapped into oblivion by the Vogon Pest Control Beam. end the story finally saying

You have died.

-- you hear the rumble of a truck pulling into the driveway. --
-- you hear a loud thump from the area of the front porch, and then a truck roaring away. --

    *** The End ***

In that game you scored 0 out of a possible 60, in 181 turns, earning you the rank of Boring person.

Would you like to RESTART, RESTORE a saved game, QUIT, or UNDO the last command?

>restart
You are in a house in the countryside.  You are into electronics, and it is night time.

Rogers Rd
An Interactive Fiction by Dan Bowen, Version 1.2beta
Release 1 / Serial number 201110 / Inform 7 build 6M62 (I6/v6.34 lib 6/12N) SD

Front Porch
You can see a front door here.

You can go north and south through the front door (closed) from here.

>s
(first opening the front door)

Foyer
Lined with a linoluem floor.

You can see a front door and an Ironing Board (on which is a can of starch) here.

You can go north through the front door to the Front Porch, south, east, and west from here.

* * *

>d
(first opening the cellar stairs)

cellar
You can see a cellar stairs here.

You can go north, west, and up through the cellar stairs to the back hallway from here.

>wait until 1 am
--- You notice a faint sound in the far distance, as if a ray gun were charging up. ----
At the stroke of 11:00, radiation beams sweep across the land, penetrating buildings and open spaces alike.
You hear a zapping noise from the house above.  The ground around the cellar has blocked the radiation beams from burninating you.

You have survived!

[Your score has just gone up by twenty points.]

-- you hear the rumble of a truck pulling into the driveway. --
-- you hear a loud thump from the area of the front porch, and then a truck roaring away. --
The time is now 1:00 am.

* * *

The sun has set outside.

You are in a house in the countryside.  You are into electronics, and it is 10:00 pm
Rogers Rd
An Interactive Fiction by Dan Bowen, Version 1.2beta
Release 1 / Serial number 201111 / Inform 7 build 6M62 (I6/v6.34 lib 6/12N) SD

Front Porch
You can see a front door here.

You can go north and south through the front door (closed) from here.

>z
Time passes.

-- you hear the rumble of a truck pulling into the driveway. --

I beg your pardon?

>z
Time passes.

-- you hear a loud thump from the area of the front porch, and then a truck roaring away. --

>get all
There are none at all available!

>look
Front Porch
You can see a large wooden box (closed) and a front door here.

You can go north and south through the front door (closed) from here.

>get
What do you want to get?

>get all
There are none at all available!

>get box
That's fixed in place.

>open box
You open the large wooden box, revealing a liquid methane generator and a methane manual.

>get
What do you want to get?

>all
liquid methane generator: Taken.
methane manual: Taken.

>examine generator
The liquid methane generator is currently switched off.

* * *

>z
Time passes.

-- you hear a loud thump from the area of the front porch, and then a truck roaring away. --

>look
Front Porch
You can see a large wooden box (closed) and a front door here.

You can go north and south through the front door (closed) from here.

>open box
You open the large wooden box, revealing a liquid methane generator and a methane manual.

* * *

>z
Time passes.

-- you hear a loud thump from the area of the front porch, and then a truck roaring away. --

>open box
You open the large wooden box, revealing a liquid methane generator and a methane manual.

>examine generator
A metal frame containing a massive number of stainless steel tubes, valves, and electronic control systems.

The liquid methane generator is currently switched off.

* * *

>z
Time passes.

-- you hear a loud thump from the area of the front porch, and then a truck roaring away. --

>restart
Are you sure you want to restart?

* * *

>y
You are in a house in the countryside.  You are into electronics, and it is night time.

Rogers Rd
An Interactive Fiction by Dan Bowen, Version 1.1beta
Release 1 / Serial number 201108 / Inform 7 build 6M62 (I6/v6.34 lib 6/12N) SD

Front Porch
You can see a front door here.

You can go north and south through the front door (closed) from here.

>test gen
(Testing.)

>[1] z
Time passes.

-- you hear the rumble of a truck pulling into the driveway. --
>[2] z
Time passes.

-- you hear a loud thump from the area of the front porch, and then a truck roaring away. --
>[3] open box
You open the large wooden box, revealing a liquid methane generator and a liquid oxygen generator.

>[4] get all
liquid methane generator: Taken.
liquid oxygen generator: Taken.

>[5] examine methane generator
A metal frame containing a massive number of stainless steel tubes, valves, and electronic control systems. Printed on the side it says, "Your  GasCo CH4 Generator will take ambient humid air and convert it into liquid methane.  It has an output pipe that is 1.5 inches in diameter."

The liquid methane generator is currently switched off.

>[6] examine oxygen generator
A large, white metal cabinet machine.  Printed on the side it says, "Your  GasCo O2 Generator will take ambient air and convert it into liquid oxygen.  It has an output pipe that is 2 inches in diameter."

The liquid oxygen generator is currently switched off.

* * *

>s
(first opening the front door)

Foyer
Lined with a linoluem floor.

You can see a front door and an Ironing Board (on which is a can of starch) here.

You can go north through the front door to the Front Porch, south, east and west from here.

>i
You are carrying:
  a liquid oxygen generator
  a liquid methane generator

>s
dining room
This room has a green rug.

You can go north to the Foyer, south and east from here.

* * *

>n
radiostation
A suite of electronics is jammed into the small room. There is nothing to do with them, it appears fully automated.

You can see a black pipe here.

You can go south to the cellar from here.

>drop methane generator
fart on you

* * *

>z
Time passes.

-- you hear the rumble of a truck pulling into the driveway. --

>look
Front Porch
You can see a large wooden box (closed) and a front door here.

You can go north and south through the front door (closed) from here.

>x box
The box is about 2ft x 3ft x 5ft in size. It has the words "GasCo Industries Model 7" stencilled on the side.  It is addressed to you.

>open box
It isn't something you can open.

* * *

>z
Time passes.

-- you hear the rumble of a truck pulling into the driveway. --

>open box
You open the large wooden box, revealing a liquid methane generator and a methane manual.

* * *

>z
Time passes.

-- you hear the rumble of a truck pulling into the driveway. --

>restart
You are in a house in the countryside.  You are into electronics, and it is night time.

Rogers Rd
An Interactive Fiction by Dan Bowen
Release 1 / Serial number 201108 / Inform 7 build 6M62 (I6/v6.34 lib 6/12N) SD

Front Porch
You can see a front door here.

You can go north and south through the front door (closed) from here.

* * *

>d
(first opening the cellar stairs)

cellar
You can see a cellar stairs here.

You can go north, west and up through the cellar stairs to the back hallway from here.

>w
Furnace room
You can go east to the cellar from here.

Radiation beams sweep across the land, penetrating buildings and open spaces alike.
good on you.

* * *

>d
(first opening the cellar stairs)

cellar
You can see a cellar stairs here.

You can go north, west and up through the cellar stairs to the back hallway from here.

>z
Time passes.

At the stroke of 11, radiation beams sweep across the land, penetrating buildings and open spaces alike.
You hear a zapping noise from the house above.  The radiation is shielded from you by the ground around the cellar.

You have survived!

[Your score has just gone up by twenty points.]

* * *

>z
Time passes.

>look
Front Porch
You can see a large wooden box (closed) and a front door here.

You can go north and south through the front door (closed) from here.