Starship Testing
An Interactive Fiction by Dan Bowen, Version 1.2
Release 1 / Serial number 201112 / Inform 7 build 6M62 (I6/v6.34 lib 6/12N) SD

West side yard
the ground here is blackened.

You can see an end of the red hose, an end of the blue hose and a Starship here.

You can go up from here.

I beg your pardon?

* * *

Starship Testing
An Interactive Fiction by Dan Bowen, Version 1.2
Release 1 / Serial number 201112 / Inform 7 build 6M62 (I6/v6.34 lib 6/12N) SD

West side yard
the ground here is blackened.

You can see an end of the red hose, an end of the blue hose and a Starship here.

You can go up from here.

>test shipin
(Testing.)

>[1] u

ladder
You can go up and down to West side yard from here.

>[2] u

Top of ladder
You can see a shiny hatch here.

You can go down to the ladder from here.

>[3] w
You open the shiny hatch.

airlock
You are in a small chamber with controls on the walls.   The outer hatch is to the east, and the inner hatch is to the west.

You can also see an airlock inner hatch and an egress interlock here.

You can see no obvious exits.

>[4] turn interlock on
you hear a hiss, and then both hatches emit a loud KERCHUNK.

>[5] w
You open the airlock inner hatch.

main hallway
You can see an airlock hall hatch here.

You can go up from here.

I beg your pardon?

>n
You can't go that way.

>u
control room
You can see an abort system, a navigation computer and an autopilot here.

You can go down to the main hallway from here.

* * *

Starship Testing
An Interactive Fiction by Dan Bowen, Version 1.2
Release 1 / Serial number 201112 / Inform 7 build 6M62 (I6/v6.34 lib 6/12N) SD

West side yard
the ground here is blackened.

You can see an end of the red hose, an end of the blue hose and a Starship here.

You can go up from here.

>get
What do you want to get?

>all
end of the red hose end: Taken.
end of the blue hose end: Taken.

>put red in o2
You put the end of the red hose end into the O2 fill port.

* * *

Starship Testing
An Interactive Fiction by Dan Bowen, Version 1.2
Release 1 / Serial number 201112 / Inform 7 build 6M62 (I6/v6.34 lib 6/12N) SD

West side yard
the ground here is blackened.

You can see an end of the red hose, an end of the blue hose and a Starship here.

You can go up from here.

>get all
end of the red hose: Taken.
end of the blue hose: Taken.

>put blue in ch4
You put the end of the blue hose into the CH4 fill port.

fueling CH4

>x displau
You can't see any such thing.

>x display
 
 Fuel Quantities: 
 O2 Tank Level 0%
 CH4 tank level 10%

fueling CH4

>x display
 
 Fuel Quantities: 
 O2 Tank Level 0%
 CH4 tank level 20%

fueling CH4

>x display
 
 Fuel Quantities: 
 O2 Tank Level 0%
 CH4 tank level 30%

fueling CH4

>x display
 
 Fuel Quantities: 
 O2 Tank Level 0%
 CH4 tank level 40%

fueling CH4

>x display
 
 Fuel Quantities: 
 O2 Tank Level 0%
 CH4 tank level 50%

fueling CH4

>x display
 
 Fuel Quantities: 
 O2 Tank Level 0%
 CH4 tank level 60%

fueling CH4

>x display
 
 Fuel Quantities: 
 O2 Tank Level 0%
 CH4 tank level 70%

fueling CH4

>x display
 
 Fuel Quantities: 
 O2 Tank Level 0%
 CH4 tank level 80%

fueling CH4

>x display
 
 Fuel Quantities: 
 O2 Tank Level 0%
 CH4 tank level 90%

fueling CH4

>x display
 
 Fuel Quantities: 
 O2 Tank Level 0%
 CH4 tank level 100%

You hear a loud clunk back toward the house, and the blue hose pops out of the port onto the ground, having shut off automatically.

* * *

>get all
end of the red hose: Taken.
end of the blue hose: Taken.

>put blue in o2
You put the end of the blue hose into the O2 fill port.

>put red in o2
There is no more room in the O2 fill port.

* * *

>get all
end of the red hose: Taken.
end of the blue hose: Taken.

>put red hose in o2
You put the end of the red hose into the O2 fill port.

fuelling O2

>put blue hose in ch4
You put the end of the blue hose into the CH4 fill port.

fuelling O2fuelling CH4

>x display
 
 Fuel Quantities: 
 O2 Tank Level 10%
 CH4 tank level 10%

fuelling O2fuelling CH4

>x displau
You can't see any such thing.

>x display
 
 Fuel Quantities: 
 O2 Tank Level 15%
 CH4 tank level 20%

fuelling O2fuelling CH4

>x display
 
 Fuel Quantities: 
 O2 Tank Level 20%
 CH4 tank level 30%

fuelling O2fuelling CH4

>x display
 
 Fuel Quantities: 
 O2 Tank Level 25%
 CH4 tank level 40%

fuelling O2fuelling CH4

>x display
 
 Fuel Quantities: 
 O2 Tank Level 30%
 CH4 tank level 50%

fuelling O2fuelling CH4

>x display
 
 Fuel Quantities: 
 O2 Tank Level 35%
 CH4 tank level 60%

fuelling O2fuelling CH4

>x display
 
 Fuel Quantities: 
 O2 Tank Level 40%
 CH4 tank level 70%

fuelling O2fuelling CH4

>x display
 
 Fuel Quantities: 
 O2 Tank Level 45%
 CH4 tank level 80%

fuelling O2fuelling CH4

>x display
 
 Fuel Quantities: 
 O2 Tank Level 50%
 CH4 tank level 90%

fuelling O2fuelling CH4

>x display
 
 Fuel Quantities: 
 O2 Tank Level 55%
 CH4 tank level 100%

fuelling O2You hear a loud clunk back toward the house, and the blue hose pops out of the port onto the ground, having shut off automatically.

>x display
 
 Fuel Quantities: 
 O2 Tank Level 60%
 CH4 tank level 100%

fuelling O2

>x display
 
 Fuel Quantities: 
 O2 Tank Level 65%
 CH4 tank level 100%

fuelling O2

>x display
 
 Fuel Quantities: 
 O2 Tank Level 70%
 CH4 tank level 100%

fuelling O2

>x display
 
 Fuel Quantities: 
 O2 Tank Level 75%
 CH4 tank level 100%

fuelling O2

>x display
 
 Fuel Quantities: 
 O2 Tank Level 80%
 CH4 tank level 100%

fuelling O2

>x display
 
 Fuel Quantities: 
 O2 Tank Level 85%
 CH4 tank level 100%

fuelling O2

>x display
 
 Fuel Quantities: 
 O2 Tank Level 90%
 CH4 tank level 100%

fuelling O2

>x display
 
 Fuel Quantities: 
 O2 Tank Level 95%
 CH4 tank level 100%

fuelling O2

>x display
 
 Fuel Quantities: 
 O2 Tank Level 100%
 CH4 tank level 100%

You hear a loud clunk back toward the house, and the red hose pops out of the port onto the ground, having shut off automatically.

* * *

>get all
end of the red hose: Taken.
end of the blue hose: Taken.

>put red in O2
You put the end of the red hose into the O2 fill port.

fuelling O2

>put blue in ch4
You put the end of the blue hose into the CH4 fill port.

fuelling O2
fueling CH4

>u
ladder
You can go up and down to West side yard from here.

fuelling O2
fueling CH4

>u
Top of ladder
You can see a shiny hatch here.

You can go down to the ladder from here.

fuelling O2
fueling CH4

>w
You open the shiny hatch.

airlock
You are in a small chamber with controls on the walls.   The outer hatch is to the east, and the inner hatch is to the west.

You can also see an airlock inner hatch and an egress interlock here.

You can see no obvious exits.

fuelling O2
fueling CH4

>turn interlock on
you hear a hiss, and then both hatches emit a loud KERCHUNK.

fuelling O2
fueling CH4

>w
You open the airlock inner hatch.

main hallway
You can see an airlock hall hatch here.

You can go up from here.

fuelling O2
fueling CH4

>u
control room
You can see an abort system, a navigation computer and an autopilot here.

You can go down to the main hallway from here.

fuelling O2
fueling CH4

>turn autopilot on
Insufficient Oxygen. Insufficient methane. 
fuelling O2
fueling CH4

>turn autopilot on
Insufficient Oxygen. Insufficient methane. 
fuelling O2
fueling CH4

>turn autopilot on
Insufficient Oxygen. Methane Full.

fuelling O2

>turn autopilot on
Insufficient Oxygen. Methane Full.

fuelling O2

>turn autopilot on
Oxygen Full.
Methane Full.
RUD!

>turn autopilot off
You switch the autopilot off.

>d
main hallway
You can see an airlock hall hatch here.

You can go up to the control room from here.

>e
You open the airlock hall hatch.

airlock
You are in a small chamber with controls on the walls.   The outer hatch is to the east, and the inner hatch is to the west.

You can also see an airlock inner hatch and an egress interlock here.

You can see no obvious exits.

>turn interlock off
you hear a hiss, and then both hatches emit a loud KERCHUNK.

>e
You open the airlock outer hatch.

Top of ladder
You can see a shiny hatch here.

You can go down to the ladder from here.

>d
ladder
You can go up to Top of ladder and down to West side yard from here.

>d
West side yard
You can see a starship here.

You can go up to the ladder from here.

You hear a loud clunk back toward the house, and the red hose pops out of the port onto the ground, having shut off automatically.
You hear a faint thunk from the back yard, and the blue hose pops out of the port onto the ground, having shut off automatically.

>u
ladder
You can go up to Top of ladder and down to West side yard from here.

>u
Top of ladder
You can see a shiny hatch here.

You can go down to the ladder from here.

>w
airlock
You are in a small chamber with controls on the walls.   The outer hatch is to the east, and the inner hatch is to the west.

You can also see an airlock inner hatch and an egress interlock here.

You can see no obvious exits.

>turn interlock on
you hear a hiss, and then both hatches emit a loud KERCHUNK.

>w
You open the airlock inner hatch.

main hallway
You can see an airlock hall hatch here.

You can go up to the control room from here.

>u
control room
You can see an abort system, a navigation computer and an autopilot here.

You can go down to the main hallway from here.

>turn autopilot on
Oxygen Full.
Methane Full.

 Blastoff!

* * *

>put red in O2
You put the end of the red hose into the O2 fill port.

fuelling O2

>x display
 
 Fuel Quantities: 
 O2 Tank Level 5%
 CH4 tank level 0%

fuelling O2

>x display
 
 Fuel Quantities: 
 O2 Tank Level 10%
 CH4 tank level 0%

fuelling O2

>x display
 
 Fuel Quantities: 
 O2 Tank Level 15%
 CH4 tank level 0%

fuelling O2

>x display
 
 Fuel Quantities: 
 O2 Tank Level 20%
 CH4 tank level 0%

fuelling O2

>x display
 
 Fuel Quantities: 
 O2 Tank Level 25%
 CH4 tank level 0%

fuelling O2

>x display
 
 Fuel Quantities: 
 O2 Tank Level 30%
 CH4 tank level 0%

fuelling O2

>x display
 
 Fuel Quantities: 
 O2 Tank Level 35%
 CH4 tank level 0%

fuelling O2

>x display
 
 Fuel Quantities: 
 O2 Tank Level 40%
 CH4 tank level 0%

fuelling O2

>x display
 
 Fuel Quantities: 
 O2 Tank Level 45%
 CH4 tank level 0%

fuelling O2

>x display
 
 Fuel Quantities: 
 O2 Tank Level 50%
 CH4 tank level 0%

fuelling O2

>x display
 
 Fuel Quantities: 
 O2 Tank Level 55%
 CH4 tank level 0%

fuelling O2

>x display
 
 Fuel Quantities: 
 O2 Tank Level 60%
 CH4 tank level 0%

fuelling O2

* * *

>get all
end of the red hose: Taken.
end of the blue hose: Taken.

>put red in O2 port
You put the end of the red hose end into the O2 fill port.

fuelling O2

I beg your pardon?

>s
You can't go that way.

fuelling O2

>z
Time passes.

fuelling O2

* * *

>get all
end of the red hose: Taken.
end of the blue hose: Taken.

>put red in o2
You put the end of the red hose into the O2 fill port.

fuelling O2

>put blue in CH4
You put the end of the blue hose into the CH4 fill port.

fuelling O2
fueling CH4

>u
ladder
You can go up and down to West side yard from here.

fuelling O2
fueling CH4

* * *

>u
Top of ladder
You can see a shiny hatch here.

You can go down to the ladder from here.

fuelling O2
fueling CH4

>u
You can't go that way.

fuelling O2
fueling CH4

>w
You open the shiny hatch.

airlock
You are in a small chamber with controls on the walls.   The outer hatch is to the east, and the inner hatch is to the west.

You can also see an airlock inner hatch and an egress interlock here.

You can see no obvious exits.

fuelling O2
fueling CH4

>x egress
Hello

The egress interlock is currently switched off.

fuelling O2
fueling CH4

>turn interlock on
you hear a hiss, and then both hatches emit a loud KERCHUNK.

fuelling O2
fueling CH4

* * *

>u
control room
You can see an abort system, a navigation computer and an autopilot here.

You can go down to the main hallway from here.

fuelling O2
fueling CH4

>u
You can't go that way.

fuelling O2
fueling CH4

>turn autopilot on
Insufficient Oxygen. Methane Full.

fuelling O2

>turn autopilot on
Oxygen Full.
Methane Full.
RUD!

    *** The End ***

Would you like to RESTART, RESTORE a saved game, QUIT or UNDO the last command?

* * *

>put red in o2
You put the end of the red hose into the O2 fill port.

fuelling O2

>put blue in ch4
You put the end of the blue hose into the CH4 fill port.

fuelling O2
fueling CH4

* * *

>w
You open the airlock inner hatch.

main hallway
You can see an airlock hall hatch here.

You can go up from here.

fuelling O2
fueling CH4

>u
control room
You can see an abort system, a navigation computer, control display and an autopilot here.

You can go down to the main hallway from here.

fuelling O2
fueling CH4

>turn autopilot on
Insufficient Oxygen. Insufficient methane. 
fuelling O2
fueling CH4

* * *

>turn autopilot on
Insufficient Oxygen. Methane Full.

fuelling O2

>turn autopilot on
Oxygen Full.
Methane Full.
The engines roar, the rocket rises away from the ground.  A hose, still connected to a fill port, tears the fuel manifold out of the bottom of the ship.  A large explosion consumes the rocket instantly. 

    *** You have died. ***

Would you like to RESTART, RESTORE a saved game, QUIT or UNDO the last command?

* * *

>u
control room
You can see an abort system, a navigation computer, control display and an autopilot here.

You can go down to the main hallway from here.

fuelling O2
fueling CH4

>u
You can't go that way.

fuelling O2
fueling CH4

>turn autopilot on
Insufficient Oxygen. Insufficient methane. 
fuelling O2
fueling CH4

* * *

>turn autopilot on
Insufficient Oxygen. Methane Full.

fuelling O2

>turn autopilot on
Oxygen Full.
Methane Full.
Blastoff!

>turn autopilot on
That's already on.

>showme red hose
end of the red hose - thing
location: in the O2 fill port , which is part of the set of ports , which is part of the starship in West side yard
singular-named, improper-named; unlit, inedible, portable, handled
list grouping key: none
printed name: "end of the red hose"
printed plural name: none
indefinite article: none
description: none
initial appearance: none

* * *

>u
control room
You can see an abort system, a navigation computer, control display and an autopilot here.

You can go down to the main hallway from here.

fuelling O2
fueling CH4

>x display
 
 ~ Starship Status Console ~
 Fuel Quantities: 
 Oxygen Tank Level 40%
 Methane Tank level 70%

fuelling O2
fueling CH4

>turn autopilot on
Insufficient Oxygen. Insufficient methane. autopilot turns off.

fuelling O2
fueling CH4

>s
You can't go that way.

fuelling O2
fueling CH4

>d
main hallway
You can see an airlock hall hatch here.

You can go up to the control room from here.

fuelling O2

>e
You open the airlock hall hatch.

airlock
You are in a small chamber with controls on the walls.   The outer hatch is to the east, and the inner hatch is to the west.

You can also see an airlock inner hatch and an egress interlock here.

You can see no obvious exits.

fuelling O2

>turn interlock off
you hear a hiss, and then both hatches emit a loud KERCHUNK.

fuelling O2

>e
You open the airlock outer hatch.

Top of ladder
You can see a shiny hatch here.

You can go down to the ladder from here.

fuelling O2

>d
ladder
You can go up to Top of ladder and down to West side yard from here.

fuelling O2

>d
West side yard
You can see a starship here.

You can go up to the ladder from here.

fuelling O2
You hear a faint thunk from the back yard, and the blue hose pops out of the port onto the ground, having shut off automatically.

>x display
 
 Fuel Quantities: 
 O2 Tank Level 85%
 CH4 tank level 100%

fuelling O2

* * *

>w
You open the shiny hatch.

airlock
You are in a small chamber with controls on the walls.   The outer hatch is to the east, and the inner hatch is to the west.

You can also see an airlock inner hatch and an egress interlock here.

You can see no obvious exits.

fuelling O2
fueling CH4

>turn on
(the printout)
It isn't something you can switch.

fuelling O2
fueling CH4

>turn interlock on
you hear a hiss, and then both hatches emit a loud KERCHUNK.

fuelling O2
fueling CH4

>q
Are you sure you want to quit?

* * *

>w
You open the airlock inner hatch.

main hallway
You can see an airlock hall hatch here.

You can go up from here.

fuelling O2
fueling CH4

* * *

>u
control room
You can see an abort system, a navigation computer, control display and an autopilot here.

You can go down to the main hallway from here.

fuelling O2
fueling CH4

>x display
 
 ~ Starship Status Console ~ Fuel Quantities: 
 O2 Tank Level 45%
 CH4 tank level 80%

fuelling O2
fueling CH4

>x
(the printout)
You see nothing special about the printout.

fuelling O2
fueling CH4

>x display
 
 ~ Starship Status Console ~ Fuel Quantities: 
 O2 Tank Level 55%
 CH4 tank level 100%

fuelling O2

>turn autopilot on
Insufficient Oxygen. Methane Full.

fuelling O2

>x display
 
 ~ Starship Status Console ~ Fuel Quantities: 
 O2 Tank Level 70%
 CH4 tank level 100%

fuelling O2

>d
main hallway
You can see an airlock hall hatch here.

You can go up to the control room from here.

fuelling O2

* * *

>d
ladder
You can go up to Top of ladder and down to West side yard from here.

fuelling O2

>d
West side yard
You can see a starship here.

You can go up to the ladder from here.

You hear a loud clunk back toward the house, and the red hose pops out of the port onto the ground, having shut off automatically.
You hear a faint thunk from the back yard, and the blue hose pops out of the port onto the ground, having shut off automatically.

* * *

>w
You open the airlock inner hatch.

main hallway
You can see an airlock hall hatch here.

You can go up to the control room from here.

>u
control room
You can see an abort system, a navigation computer, control display and an autopilot here.

You can go down to the main hallway from here.

>x display
 
 ~ Starship Status Console ~ Fuel Quantities: 
 O2 Tank Level 100%
 CH4 tank level 100%

>turn autopilot on
Oxygen Full.
Methane Full.

 Blastoff!

* * *

>put blue in ch4
You put the end of the blue hose into the CH4 fill port.

fuelling O2
fueling CH4

>x display
 
 Fuel Quantities: 
 O2 Tank Level 10%
 CH4 tank level 10%

fuelling O2
fuelling CH4

>x display
 
 Fuel Quantities: 
 O2 Tank Level 15%
 CH4 tank level 20%

fuelling O2
fuelling CH4

>x display
 
 Fuel Quantities: 
 O2 Tank Level 20%
 CH4 tank level 30%

fuelling O2
fuelling CH4

>x display
 
 Fuel Quantities: 
 O2 Tank Level 25%
 CH4 tank level 40%

fuelling O2
fuelling CH4

>x display
 
 Fuel Quantities: 
 O2 Tank Level 30%
 CH4 tank level 50%

fuelling O2
fuelling CH4

>x display
 
 Fuel Quantities: 
 O2 Tank Level 35%
 CH4 tank level 60%

fuelling O2
fuelling CH4

>x display
 
 Fuel Quantities: 
 O2 Tank Level 40%
 CH4 tank level 70%

fuelling O2
fuelling CH4

>x display
 
 Fuel Quantities: 
 O2 Tank Level 45%
 CH4 tank level 80%

fuelling O2
fuelling CH4

>x display
 
 Fuel Quantities: 
 O2 Tank Level 50%
 CH4 tank level 90%

fuelling O2
fuelling CH4

>x display
 
 Fuel Quantities: 
 O2 Tank Level 55%
 CH4 tank level 100%

fuelling O2
You hear a loud clunk back toward the house, and the blue hose pops out of the port onto the ground, having shut off automatically.

>x display
 
 Fuel Quantities: 
 O2 Tank Level 60%
 CH4 tank level 100%

fuelling O2

* * *

>x display
 
 Fuel Quantities: 
 O2 Tank Level 100%
 CH4 tank level 100%

You hear a loud clunk back toward the house, and the red hose pops out of the port onto the ground, having shut off automatically.

>look
West side yard
You can see an end of the red hose, an end of the blue hose and a starship here.

You can go up from here.

>u
ladder
You can go up and down to West side yard from here.

>d
West side yard
You can see an end of the red hose, an end of the blue hose and a starship here.

You can go up to the ladder from here.

>restart
Are you sure you want to restart?

>y
Starship Testing
An Interactive Fiction by Dan Bowen, Version 1
Release 1 / Serial number 201109 / Inform 7 build 6M62 (I6/v6.34 lib 6/12N) SD

West side yard
You can see an end of the red hose, an end of the blue hose and a starship here.

You can go up from here.

>get all
end of the red hose: Taken.
end of the blue hose: Taken.

>put blue hose in o2
You put the end of the blue hose into the O2 fill port.

>x display
 
 Fuel Quantities: 
 O2 Tank Level 0%
 CH4 tank level 0%

>put red in o2
You put the end of the red hose into the O2 fill port.

fuelling O2

>get blue
Taken.

fuelling O2

* * *

>put red in o2
You put the end of the red hose into the O2 fill port.

fuelling O2

>u
ladder
You can go up and down to West side yard from here.

fuelling O2

>u
Top of ladder
You can see a shiny hatch here.

You can go down to the ladder from here.

fuelling O2

>w
You open the shiny hatch.

airlock
You are in a small chamber with controls on the walls.   The outer hatch is to the east, and the inner hatch is to the west.

You can also see an airlock inner hatch and an egress interlock here.

You can see no obvious exits.

fuelling O2

>turn interlock on
you hear a hiss, and then both hatches emit a loud KERCHUNK.

fuelling O2

>w
You open the airlock inner hatch.

main hallway
You can see an airlock hall hatch here.

You can go up from here.

fuelling O2

>u
control room
You can see an abort system, a navigation computer and an autopilot here.

You can go down to the main hallway from here.

fuelling O2

>turn autopilot on
Insufficient Oxygen. Terminating autopilot.
insufficient methane.  Terminating autopilot.

fuelling O2

>turn autopilot on
Insufficient Oxygen. Terminating autopilot.
insufficient methane.  Terminating autopilot.

fuelling O2

>turn autopilot on
Oxygen Full.
insufficient methane.  Terminating autopilot.

>turn autopilot on
Oxygen Full.
insufficient methane.  Terminating autopilot.

>look
control room
You can see an abort system, a navigation computer and an autopilot here.

You can go down to the main hallway from here.

>d
main hallway
You can see an airlock hall hatch here.

You can go up to the control room from here.

* * *

>d
ladder
You can go up to Top of ladder and down to West side yard from here.

>d
West side yard
You can see a starship here.

You can go up to the ladder from here.

You hear a loud clunk back toward the house, and the red hose pops out of the port onto the ground, having shut off automatically.

>get blue hose
You already have that.

>put blue in ch4
You put the end of the blue hose into the CH4 fill port.

fueling CH4

* * *

>x displau
You can't see any such thing.

>x display
 
 Fuel Quantities: 
 O2 Tank Level 100%
 CH4 tank level 16%

fueling CH4

>x display
 
 Fuel Quantities: 
 O2 Tank Level 100%
 CH4 tank level 32%

fueling CH4

>x display
 
 Fuel Quantities: 
 O2 Tank Level 100%
 CH4 tank level 48%

fueling CH4

>x display
 
 Fuel Quantities: 
 O2 Tank Level 100%
 CH4 tank level 64%

fueling CH4

>x display
 
 Fuel Quantities: 
 O2 Tank Level 100%
 CH4 tank level 80%

fueling CH4

>x display
 
 Fuel Quantities: 
 O2 Tank Level 100%
 CH4 tank level 96%

fueling CH4

>x display
 
 Fuel Quantities: 
 O2 Tank Level 100%
 CH4 tank level 112%

You hear a loud clunk back toward the house, and the blue hose pops out of the port onto the ground, having shut off automatically.

>x display
 
 Fuel Quantities: 
 O2 Tank Level 100%
 CH4 tank level 112%

* * *

>put red in o2
You put the end of the red hose into the O2 fill port.

fuelling O2

>x displau
You can't see any such thing.

>x display
 
 Fuel Quantities: 
 O2 Tank Level 5%
 CH4 tank level 0%

fuelling O2

* * *

>x display
 
 Fuel Quantities: 
 O2 Tank Level 25%
 CH4 tank level 0%

fuelling O2

>e
You can't go that way.

fuelling O2

>u
ladder
You can go up and down to West side yard from here.

fuelling O2

>z
Time passes.

fuelling O2

>z
Time passes.

fuelling O2

>zz
That's not a verb I recognise.

>z
Time passes.

fuelling O2

>z
Time passes.

>d
West side yard
You can see a starship here.

You can go up to the ladder from here.

You hear a loud clunk back toward the house, and the red hose pops out of the port onto the ground, having shut off automatically.

>look
West side yard
You can see an end of the red hose end and a starship here.

You can go up to the ladder from here.

>u
ladder
You can go up and down to West side yard from here.

>d
West side yard
You can see an end of the red hose end and a starship here.

You can go up to the ladder from here.

* * *

>x display
 
 Fuel Quantities: 
 O2 Tank Level 60%
 CH4 tank level 0%

fuelling O2

>x display
 
 Fuel Quantities: 
 O2 Tank Level 65%
 CH4 tank level 0%

fuelling O2

>x display
 
 Fuel Quantities: 
 O2 Tank Level 70%
 CH4 tank level 0%

fuelling O2

>x display
 
 Fuel Quantities: 
 O2 Tank Level 75%
 CH4 tank level 0%

fuelling O2

I beg your pardon?

>x display
 
 Fuel Quantities: 
 O2 Tank Level 80%
 CH4 tank level 0%

fuelling O2

>x display
 
 Fuel Quantities: 
 O2 Tank Level 85%
 CH4 tank level 0%

fuelling O2

>x display
 
 Fuel Quantities: 
 O2 Tank Level 90%
 CH4 tank level 0%

fuelling O2

>x display
 
 Fuel Quantities: 
 O2 Tank Level 95%
 CH4 tank level 0%

fuelling O2

>x display
 
 Fuel Quantities: 
 O2 Tank Level 100%
 CH4 tank level 0%

You hear a loud clunk back toward the house, and the red hose pops out of the port onto the ground, having shut off automatically.

>look
West side yard
You can see an end of the red hose end and a starship here.

You can go up from here.

* * *

>put red in o2
You put the end of the red hose into the O2 fill port.

fuelling O2

>x display
 
 Fuel Quantities: 
 O2 Tank Level 5%
 CH4 tank level 0%

fuelling O2

* * *

>x display
 
 Fuel Quantities: 
 O2 Tank Level 30%
 CH4 tank level 0%

fuelling O2

I beg your pardon?

>x display
 
 Fuel Quantities: 
 O2 Tank Level 35%
 CH4 tank level 0%

fuelling O2

* * *

>x display
 
 Fuel Quantities: 
 O2 Tank Level 75%
 CH4 tank level 0%

fuelling O2

>x display
 
 Fuel Quantities: 
 O2 Tank Level 80%
 CH4 tank level 0%

fuelling O2

* * *

>x display
 
 Fuel Quantities: 
 O2 Tank Level 95%
 CH4 tank level 0%

fuelling O2

>x display
 
 Fuel Quantities: 
 O2 Tank Level 100%
 CH4 tank level 0%

>x display
 
 Fuel Quantities: 
 O2 Tank Level 100%
 CH4 tank level 0%

>x display
 
 Fuel Quantities: 
 O2 Tank Level 105%
 CH4 tank level 0%

>x display
 
 Fuel Quantities: 
 O2 Tank Level 105%
 CH4 tank level 0%

* * *

Starship Testing
An Interactive Fiction by Dan Bowen, Version 1.2
Release 1 / Serial number 201112 / Inform 7 build 6M62 (I6/v6.34 lib 6/12N) SD

West side yard
the ground here is blackened.

You can see an end of the red hose, an end of the blue hose and a Starship here.

You can go up from here.

>get starship
very funny.  You are not a crane.

* * *

Starship Testing
An Interactive Fiction by Dan Bowen, Version 1.2
Release 1 / Serial number 201112 / Inform 7 build 6M62 (I6/v6.34 lib 6/12N) SD

West side yard
the ground here is blackened.

You can see an end of the red hose, an end of the blue hose and a Starship here.

You can go up from here.

>gonear interlock
airlock
You are in a small chamber with controls on the walls. 

You can also see an airlock inner door and an egress interlock here.

You can go east through the airlock outer door (closed) and west through the airlock inner door (closed) from here.

* * *

Starship Testing
An Interactive Fiction by Dan Bowen, Version 1.2
Release 1 / Serial number 201112 / Inform 7 build 6M62 (I6/v6.34 lib 6/12N) SD

West side yard
the ground here is blackened.

You can see an end of the red hose, an end of the blue hose and a Starship here.

You can go up from here.

>i
You are carrying:
  a printout

* * *

Starship Testing
An Interactive Fiction by Dan Bowen, Version 1.2
Release 1 / Serial number 201112 / Inform 7 build 6M62 (I6/v6.34 lib 6/12N) SD

West side yard
the ground here is blackened.

You can see an end of the red hose, an end of the blue hose and a Starship here.

You can go up from here.

>look
West side yard
You can see a starship, a red hose end and a blue hose end here.

>examine starship
A great silvery rocket, 30m tall

* * *

>look
West side yard
You can see a starship, a red hose end and a blue hose end here.

>get starship
Very funny.  You are not a crane.

>get ear
You can't see any such thing.

* * *

>look
West side yard
You can see a starship, a red hose end and a blue hose end here.

>u
Stainless steel ladder

* * *

Starship Testing
An Interactive Fiction by Dan Bowen, Version 1.2
Release 1 / Serial number 201112 / Inform 7 build 6M62 (I6/v6.34 lib 6/12N) SD

West side yard
the ground here is blackened.

You can see an end of the red hose, an end of the blue hose and a Starship here.

You can go up from here.

>put red hose end into red hose port
(first taking the red hose end)
You put the red hose end into the red hose port.

>x starship
A great silvery rocket, 30m tall, it has a set of ports at the bottom

* * *

Starship Testing
An Interactive Fiction by Dan Bowen, Version 1.2
Release 1 / Serial number 201112 / Inform 7 build 6M62 (I6/v6.34 lib 6/12N) SD

West side yard
the ground here is blackened.

You can see an end of the red hose, an end of the blue hose and a Starship here.

You can go up from here.

>put red hose in CH4 port
(first taking the red hose end)
You put the red hose end into the CH4 fill port.

* * *

Starship Testing
An Interactive Fiction by Dan Bowen, Version 1.2
Release 1 / Serial number 201112 / Inform 7 build 6M62 (I6/v6.34 lib 6/12N) SD

West side yard
the ground here is blackened.

You can see an end of the red hose, an end of the blue hose and a Starship here.

You can go up from here.

>test shipin
(Testing.)

>[1] u

ladder
You can go up and down to West side yard from here.

>[2] u

Top of ladder
You are in a small chamber with controls on the walls. 

You can go west through the airlock outer door (closed) and down to the ladder from here.

>[3] w
(first opening the airlock outer door)

airlock
You are in a small chamber with controls on the walls. 

You can also see an airlock inner door and an egress interlock here.

You can go east through the airlock outer door to Top of ladder and west through the airlock inner door (closed) from here.

>[4] turn interlock on
you hear a hiss, and then both doors emit a loud KERCHUNK.

>[5] w
(first opening the airlock inner door)

main hallway
You can see an airlock inner door here.

You can go east through the airlock inner door to the airlock and up from here.

I beg your pardon?

>u
control room
You can go down to the main hallway from here.

>x abort
You can't see any such thing.

>look
control room
You can go down to the main hallway from here.

* * *

>examine interlock
The inside interlock is currently switched on.

* * *

>switch interlock off
You switch the egress interlock off.

>w
main hallway
You can see an airlock inner door here.

You can go east through the airlock inner door to the airlock from here.

>e
airlock
You are in a small chamber with controls on the walls. 

You can also see an airlock inner door and an egress interlock here.

You can go east through the airlock outer door (closed) to Top of ladder and west through the airlock inner door to the main hallway from here.

>e
(first opening the airlock outer door)
It seems to be locked.

>switch interlock on
you hear a hiss, and then both doors emit a loud KERCHUNK.

>e
(first opening the airlock outer door)
It seems to be locked.

* * *

>turn interlock off
You switch the egress interlock off.

>lock inner door
What do you want to lock the airlock inner door with?

>x inner
You see nothing special about the airlock inner door.

>x outer
You see nothing special about the airlock outer door.

>e
(first opening the airlock outer door)
It seems to be locked.

>restart
Are you sure you want to restart?

>y
Starship Testing
An Interactive Fiction by Dan Bowen, Version 1
Release 1 / Serial number 201109 / Inform 7 build 6M62 (I6/v6.34 lib 6/12N) SD

West side yard
You can see a starship, a red hose end and a blue hose end here.

You can go up from here.

>u
ladder
You can go up and down to West side yard from here.

>u
Top of ladder
You are in a small chamber with controls on the walls. 

You can go west through the airlock outer door (closed) and down to the ladder from here.

>w
(first opening the airlock outer door)

airlock
You are in a small chamber with controls on the walls. 

You can also see an airlock inner door and an egress interlock here.

You can go east through the airlock outer door to Top of ladder and west through the airlock inner door (closed) from here.

>w
(first opening the airlock inner door)
It seems to be locked.

* * *

>u
control room
You can see an abort system here.

You can go down to the main hallway from here.

>switch abort on
abort

>move to airlock
You can't see any such thing.

>teleport to airlock
That's not a verb I recognise.

* * *

>unlock door
(with the airlock outer door)
(first taking the airlock outer door)
That's fixed in place.

>look
Top of ladder
You are in a small chamber with controls on the walls. 

You can go west through the airlock outer door (closed) and down to the ladder from here.

>w
(first opening the airlock outer door)
It seems to be locked.

>unlock the outer door
(with the airlock outer door)
(first taking the airlock outer door)
That's fixed in place.

* * *

>w
You can't go that way.

* * *

>x outer door
You see nothing special about the airlock outer door.

>e
Top of ladder
You are in a small chamber with controls on the walls. 

You can go west through the airlock outer door to the airlock and down to the ladder from here.

>w
airlock
You are in a small chamber with controls on the walls. 

You can also see an airlock inner door and an inside interlock here.

You can go east through the airlock outer door to Top of ladder and west through the airlock inner door (closed) from here.

* * *

>w
(first opening the airlock inner door)

main hallway
You can see an airlock inner door here.

You can go east through the airlock inner door to the airlock from here.

* * *

>w
You can't go that way.

>u
control room
You can see an abort system here.

You can go down to the main hallway from here.

>turn abort system on
You switch the abort system on.

* * *

>x controls
The controls is currently switched off.

* * *

Starship Testing
An Interactive Fiction by Dan Bowen, Version 1.2
Release 1 / Serial number 201112 / Inform 7 build 6M62 (I6/v6.34 lib 6/12N) SD

West side yard
the ground here is blackened.

You can see an end of the red hose, an end of the blue hose and a Starship here.

You can go up from here.

>test shiping
>--> The following tests are available:
'test shipin'

>test shippin
>--> The following tests are available:
'test shipin'

>test shipin
(Testing.)

>[1] u

ladder
You can go up and down to West side yard from here.

>[2] u

Top of ladder
You are in a small chamber with controls on the walls. 

You can go west through the airlock outer door (closed) and down to the ladder from here.

>[3] w
(first opening the airlock outer door)

airlock
You are in a small chamber with controls on the walls. 

You can also see an airlock inner door here.

You can go east through the airlock outer door to Top of ladder and west through the airlock inner door (closed) from here.

>w
(first opening the airlock inner door)
It seems to be locked.

* * *

Starship Testing
An Interactive Fiction by Dan Bowen, Version 1.2
Release 1 / Serial number 201112 / Inform 7 build 6M62 (I6/v6.34 lib 6/12N) SD

West side yard
the ground here is blackened.

You can see an end of the red hose, an end of the blue hose and a Starship here.

You can go up from here.

>u
Ladder
You can go up and down to West side yard from here.

>u
Top of ladder
A shiny hatch is here, to the west.

You can go down to the Ladder from here.

>in
You can't go that way.

>open hatch
You open the shiny hatch.

>enter hatch
airlock
You are in a small chamber with controls on the walls.   The outer hatch is to the east, and the inner hatch is to the west.

You can also see an airlock inner hatch and an egress interlock here.

You can see no obvious exits.

>e
You open the airlock outer hatch.

Top of ladder
You can see a shiny hatch here.

You can go down to the ladder from here.

>enter
airlock
You are in a small chamber with controls on the walls.   The outer hatch is to the east, and the inner hatch is to the west.

You can also see an airlock inner hatch and an egress interlock here.

You can see no obvious exits.

>e
Top of ladder
You can see a shiny hatch here.

You can go down to the ladder from here.

>w
airlock
You are in a small chamber with controls on the walls.   The outer hatch is to the east, and the inner hatch is to the west.

You can also see an airlock inner hatch and an egress interlock here.

You can see no obvious exits.

* * *

>u
Top of ladder
A shiny hatch is here, to the west.

You can go down to the Ladder from here.

>u
You can't go that way.

>w
You open the shiny hatch.

Airlock
You are in a small chamber with controls on the walls.   The outer hatch is to the east, and the inner hatch is to the west.

You can see an airlock outer hatch, an airlock inner hatch and an egress interlock here.

You can see no obvious exits.

>turn interlock on
you hear a hiss, and then both hatches emit a loud KERCHUNK.

>w
You open the airlock inner hatch.

main hallway
A sparkly white corridor.  There is an airlock to the east, and a control room above.

You can see an airlock hall hatch here.

You can go up from here.

>u
Control Room
You can see an abort system, a navigation computer, a control display and an autopilot here.

You can go down to the main hallway from here.

>x abort
Out of Order.  operation is not guaranteed.

The abort system is currently switched off.

>x navigation
This Nav-O-Co computer appears to be out of order. 

The navigation computer is currently switched off.

>x autopilot
The shiny black autopilot looks brand new, and very auto.

The autopilot is currently switched off.

>turn navigation on
The navigation computer emits a fail sound.

>turn autopilot on
Insufficient Oxygen. Insufficient methane. autopilot turns off.

>turn abort on
The faulty abort system just made something unpredictable happen to space and time.  There may be no fixing this.

>d
main hallway
A sparkly white corridor.  There is an airlock to the east, and a control room above.

You can see an airlock hall hatch here.

You can go up to the Control Room from here.

>e
You open the airlock hall hatch.

Airlock
You are in a small chamber with controls on the walls.   The outer hatch is to the east, and the inner hatch is to the west.

You can see an airlock outer hatch, an airlock inner hatch and an egress interlock here.

You can see no obvious exits.

>turn airlock off
Which do you mean, the airlock outer hatch, the airlock inner hatch or the airlock controls?

>turn interlock
It is fixed in place.

>turn controls off
It isn't something you can switch.

>turn interlock off
you hear a hiss, and then both hatches emit a loud KERCHUNK.

>get interlock
That's fixed in place.

>e
You open the airlock outer hatch.

Interdimensional space
You're floating in a gray nothing.  Not dead somehow, but this is a dead end.  

You can see no obvious exits.

* * *

>u
Top of ladder
A shiny hatch is here, to the west.

You can go down to the Ladder from here.

>w
You open the shiny hatch.

Airlock
You are in a small chamber with controls on the walls.   The outer hatch is to the east, and the inner hatch is to the west.

You can see an airlock outer hatch, an airlock inner hatch and an egress interlock here.

You can see no obvious exits.

>enter hatch
You can't see any such thing.

>out
But you aren't in anything at the moment.

>in
You can't go that way.

>e
You open the airlock outer door.

Top of ladder
You can see a shiny hatch here.

You can go down to the ladder from here.

>get door
That's fixed in place.

>get hatch
That's fixed in place.

* * *

>w
You open the shiny hatch.

Airlock
You are in a small chamber with controls on the walls.   The outer hatch is to the east, and the inner hatch is to the west.

You can see an airlock outer hatch, an airlock inner hatch and an egress interlock here.

You can see no obvious exits.

>open hatch
You open the shiny hatch.

>enter hatch
airlock
You are in a small chamber with controls on the walls. 

You can also see an airlock inner door and an egress interlock here.

You can go west through the airlock inner door (closed) from here.

>enter outer
You open the airlock outer door.

Top of ladder
You can see a shiny hatch here.

You can go down to the ladder from here.

* * *

>w
You open the shiny hatch.

Airlock
You are in a small chamber with controls on the walls.   The outer hatch is to the east, and the inner hatch is to the west.

You can see an airlock outer hatch, an airlock inner hatch and an egress interlock here.

You can see no obvious exits.

>open outer
You open the airlock outer hatch.

* * *

>w
You open the shiny hatch.

Airlock
You are in a small chamber with controls on the walls.   The outer hatch is to the east, and the inner hatch is to the west.

You can see an airlock outer hatch, an airlock inner hatch and an egress interlock here.

You can see no obvious exits.

>turn egress
It is fixed in place.

>turn egress on
you hear a hiss, and then both hatches emit a loud KERCHUNK.

>w
You open the airlock inner hatch.

main hallway
A sparkly white corridor.  There is an airlock to the east, and a control room above.

You can see an airlock hall hatch here.

You can go up from here.

>u
Control Room
The shiny black autopilot looks brand new, and very auto.

You can also see an abort system, a navigation computer and a control display here.

You can go down to the main hallway from here.

>x autopilot
The autopilot is currently switched off.

* * *

>w
You open the shiny hatch.

Airlock
You are in a small chamber with controls on the walls.   The outer hatch is to the east, and the inner hatch is to the west.

You can see an airlock outer hatch, an airlock inner hatch and an egress interlock here.

You can see no obvious exits.

>turn interlock off
That's already off.

>turn interlock on
you hear a hiss, and then both hatches emit a loud KERCHUNK.

>w
You open the airlock inner hatch.

main hallway
You can see an airlock hall hatch here.

You can go up from here.

>u
control room
You can see an abort system, a navigation computer and an autopilot here.

You can go down to the main hallway from here.

>turn autopilot on
Insufficient Oxygen.
insufficient methane.

* * *

>u
Control Room
You can see an abort system, a navigation computer, a control display and an autopilot here.

You can go down to the main hallway from here.

>auto
That's not a verb I recognise.

>x auto
The shiny black autopilot looks brand new, and very auto.

The autopilot is currently switched off.

>x nav
This Nav-O-Co computer appears to be out of order. 

The navigation computer is currently switched off.

>x screen
 
 ~ Starship Status Console ~
 Fuel Quantities: 
 Oxygen Tank Level 0%
 Methane Tank level 0%

* * *

>u
Control Room
You can see an abort system, a navigation computer, a control display and an autopilot here.

You can go down to the main hallway from here.

>turn abort on
The faulty abort system just made something unpredictable happen to space and time.  There may be no fixing this.

>d
main hallway
You can see an airlock hall hatch here.

You can go up to the control room from here.

* * *

>e
You open the airlock hall hatch.

airlock
You are in a small chamber with controls on the walls.   The outer hatch is to the east, and the inner hatch is to the west.

You can also see an airlock inner hatch and an egress interlock here.

You can see no obvious exits.

>enter
You must supply a noun.

>enter door
You can't see any such thing.

* * *

>turn interlock off
you hear a hiss, and then both hatches emit a loud KERCHUNK.

>e
You open the airlock outer hatch.

Low earth orbit
You're floating in space.  Not dead somehow, but this is a dead end.

You can see no obvious exits.

>w
You can't go that way.

>in
You can't go that way.

* * *

>turn abort on
The faulty abort system just made something unpredictable happen to space and time.  There may be no fixing this.

>x abort
Out of Order.  operation is not guaranteed.

The abort system is currently switched off.

>d
main hallway
You can see an airlock hall hatch here.

You can go up to the control room from here.

* * *

>turn interlock off
you hear a hiss, and then both hatches emit a loud KERCHUNK.

>e
You open the airlock outer hatch.

Low earth orbit
You're floating in space.  Not dead somehow, but this is a dead end.  

You can see no obvious exits.

>n
You can't go that way.

>w
You can't go that way.

>s
You can't go that way.

>e
You can't go that way.

>u
You can't go that way.

>d
You can't go that way.

>in
You can't go that way.

>out
But you aren't in anything at the moment.

* * *

>u
Control Room
You can see an abort system, a navigation computer, a control display and an autopilot here.

You can go down to the main hallway from here.

>turn navigation computer on
The navigation computer emits a fail sound.

>turn display onb
I only understood you as far as wanting to turn the control display.

>turn display on
It isn't something you can switch.

>x display
 
 ~ Starship Status Console ~
 Fuel Quantities: 
 Oxygen Tank Level 0%
 Methane Tank level 0%

>x autopilot
The autopilot is currently switched off.

* * *

>u
Control Room
You can see an abort system, a navigation computer, a control display and an autopilot here.

You can go down to the main hallway from here.

>turn navigation on
The navigation computer emits a fail sound.

>turn navigation on
The navigation computer emits a fail sound.

>x navigation
 Out of order. 

The navigation computer is currently switched off.

* * *

>u
Control Room
You can see an abort system, a navigation computer, a control display and an autopilot here.

You can go down to the main hallway from here.

>u
You can't go that way.

>read display
 
 Fuel Quantities: 
 O2 Tank Level 0%
 CH4 tank level 0%

* * *

>u
You can't go that way.

>x abort
Out of Order.  operation is not guaranteed.

The abort system is currently switched off.

>turn abort on
The faulty abort system just made something unpredictable happen to space and time.  There may be no fixing this.

* * *

>turn interlock off
you hear a hiss, and then both hatches emit a loud KERCHUNK.

>e
You open the airlock outer hatch.

Interdimensional space
You're floating in a gray nothing.  Not dead somehow, but this is a dead end.  

You can see no obvious exits.

* * *

>w
You open the shiny hatch.

Airlock
You are in a small chamber with controls on the walls.   The outer hatch is to the east, and the inner hatch is to the west.

You can see an airlock outer hatch, an airlock inner hatch and an egress interlock here.

You can see no obvious exits.

>w
It seems to be locked.

>e
You open the airlock outer hatch.

Top of ladder
You can see a shiny hatch here.

You can go down to the ladder from here.

>w
airlock
You are in a small chamber with controls on the walls.   The outer hatch is to the east, and the inner hatch is to the west.

You can also see an airlock inner hatch and an egress interlock here.

You can see no obvious exits.

>examine inner hatch
You can't see any such thing.

>look
airlock
You are in a small chamber with controls on the walls.   The outer hatch is to the east, and the inner hatch is to the west.

You can also see an egress interlock here.

You can see no obvious exits.

>enter inner door
You can't see any such thing.

>enter outer door
Top of ladder
You can see a shiny hatch here.

You can go down to the ladder from here.

* * *

>turn interlock on
you hear a hiss, and then both hatches emit a loud KERCHUNK.

>w
You open the airlock inner hatch.

main hallway
You can go up from here.

* * *

>w
It seems to be locked.

>turn interlock on
you hear a hiss, and then both doors emit a loud KERCHUNK.

>e
(first opening the airlock outer door)
It seems to be locked.

>w
(first opening the airlock inner door)

main hallway
You can see an airlock inner door here.

You can go east through the airlock inner door to the airlock from here.

>e
airlock
You are in a small chamber with controls on the walls. 

You can also see an airlock inner door and an egress interlock here.

You can go east through the airlock outer door (closed) to Top of ladder and west through the airlock inner door to the main hallway from here.

>turn interlock off
you hear a hiss, and then both doors emit a loud KERCHUNK.

>w
(first opening the airlock inner door)
It seems to be locked.

>e
(first opening the airlock outer door)

Top of ladder
You are in a small chamber with controls on the walls. 

You can go west through the airlock outer door to the airlock and down to the ladder from here.

>close door
You close the airlock outer door.

>w
(first opening the airlock outer door)

airlock
You are in a small chamber with controls on the walls. 

You can also see an airlock inner door and an egress interlock here.

You can go east through the airlock outer door to Top of ladder and west through the airlock inner door (closed) to the main hallway from here.

>turn interlock on
you hear a hiss, and then both doors emit a loud KERCHUNK.

>w
(first opening the airlock inner door)

main hallway
You can see an airlock inner door here.

You can go east through the airlock inner door to the airlock from here.

>n
You can't go that way.

* * *

>w
It seems to be locked.

>unlock inner hatch
What do you want to unlock the airlock inner hatch with?

>w
You can't see any such thing.

>look
airlock
You are in a small chamber with controls on the walls.   The outer hatch is to the east, and the inner hatch is to the west.

You can also see an airlock inner hatch and an egress interlock here.

You can see no obvious exits.

>e
You open the airlock outer hatch.

Top of ladder
You can see a shiny hatch here.

You can go down to the ladder from here.

* * *

>w
airlock
You are in a small chamber with controls on the walls.   The outer hatch is to the east, and the inner hatch is to the west.

You can also see an airlock inner hatch and an egress interlock here.

You can see no obvious exits.

>w
It seems to be locked.

>w
It seems to be locked.

>turn interlock on
you hear a hiss, and then both hatches emit a loud KERCHUNK.

* * *

>w
You open the airlock inner hatch.

main hallway
You can see an airlock hall hatch here.

You can go up from here.

>e
You open the airlock hall hatch.

airlock
You are in a small chamber with controls on the walls.   The outer hatch is to the east, and the inner hatch is to the west.

You can also see an airlock inner hatch and an egress interlock here.

You can see no obvious exits.

>w
main hallway
You can see an airlock hall hatch here.

You can go up from here.

>e
airlock
You are in a small chamber with controls on the walls.   The outer hatch is to the east, and the inner hatch is to the west.

You can also see an airlock inner hatch and an egress interlock here.

You can see no obvious exits.

>turn inerlock off
You can't see any such thing.

>turn interlock off
you hear a hiss, and then both hatches emit a loud KERCHUNK.

>w
It seems to be locked.

* * *

>turn interlock on
you hear a hiss, and then both hatches emit a loud KERCHUNK.

>e
It seems to be locked.

>w
You open the airlock inner hatch.

main hallway
You can see an airlock hall hatch here.

You can go up from here.

>u
control room
You can see an abort system here.

You can go down to the main hallway from here.

* * *

>s
You can't go that way.

>d
main hallway
You can see an airlock hall hatch here.

You can go up to the control room from here.

>e
airlock
You are in a small chamber with controls on the walls.   The outer hatch is to the east, and the inner hatch is to the west.

You can also see an airlock inner hatch and an egress interlock here.

You can see no obvious exits.

>turn interlock off
you hear a hiss, and then both hatches emit a loud KERCHUNK.

>e
You open the airlock outer hatch.

Mars
You can see no obvious exits.

* * *

>w
You open the shiny hatch.

Airlock
You are in a small chamber with controls on the walls.   The outer hatch is to the east, and the inner hatch is to the west.

You can see an airlock outer hatch, an airlock inner hatch and an egress interlock here.

You can see no obvious exits.

>x interlock
A protection device that allows only one airlock hatch to be open at once.

The egress interlock is currently switched off.

>x controls
A protection device that allows only one airlock hatch to be open at once.

The egress interlock is currently switched off.

>turn interlock on
you hear a hiss, and then both hatches emit a loud KERCHUNK.

>w
You open the airlock inner hatch.

main hallway
A sparkly white corridor.  There is an airlock hatch to the east, and a control room above.

You can see an airlock hall hatch here.

You can go up from here.

>u
Control Room
You can see an abort system, a navigation computer, control display and an autopilot here.

You can go down to the main hallway from here.

>turn navigation computer on
You switch the navigation computer on.

* * *

Starship Testing
An Interactive Fiction by Dan Bowen, Version 1.2
Release 1 / Serial number 201112 / Inform 7 build 6M62 (I6/v6.34 lib 6/12N) SD

West side yard
the ground here is blackened.

You can see an end of the red hose, an end of the blue hose and a Starship here.

You can go up from here.

>x display
 
 Fuel Quantities: 
 O2 Tank Level 5%
 CH4 tank level 99%

* * *

Starship Testing
An Interactive Fiction by Dan Bowen, Version 1.2
Release 1 / Serial number 201112 / Inform 7 build 6M62 (I6/v6.34 lib 6/12N) SD

West side yard
the ground here is blackened.

You can see an end of the red hose, an end of the blue hose and a Starship here.

You can go up from here.

>x hose
Which do you mean, the end of the red hose or the end of the blue hose?

>red
You see nothing special about the end of the red hose.

>x blue
You see nothing special about the end of the blue hose.

>x starship
A great silvery rocket, 30m tall, it has a set of ports at the bottom

* * *

Starship Testing
An Interactive Fiction by Dan Bowen, Version 1.2
Release 1 / Serial number 201112 / Inform 7 build 6M62 (I6/v6.34 lib 6/12N) SD

West side yard
the ground here is blackened.

You can see an end of the red hose, an end of the blue hose and a Starship here.

You can go up from here.

>x ports
there is a red hose connection and a blue hose connection.

>x red
You see nothing special about the red hose port.

* * *

Starship Testing
An Interactive Fiction by Dan Bowen, Version 1.2
Release 1 / Serial number 201112 / Inform 7 build 6M62 (I6/v6.34 lib 6/12N) SD

West side yard
the ground here is blackened.

You can see an end of the red hose, an end of the blue hose and a Starship here.

You can go up from here.

>x star
You can't see any such thing.

>x starship
A great silvery rocket, 30m tall

>x red hose port
You see nothing special about the red hose port.

* * *

Starship Testing
An Interactive Fiction by Dan Bowen, Version 1.2
Release 1 / Serial number 201112 / Inform 7 build 6M62 (I6/v6.34 lib 6/12N) SD

West side yard
the ground here is blackened.

You can see an end of the red hose, an end of the blue hose and a Starship here.

You can go up from here.

>x starship
A great silvery rocket, 30m tall, it has a set of hose ports at the bottom, and next to the ports is a small display screen.

>ex ports
That's not a verb I recognise.

>x ports
You see nothing special about the set of ports.

* * *

>x starship
A great silvery rocket, 30m tall, it has a set of hose ports at the bottom, and next to the ports is a small display screen.

>x ports
there is an 02 fill port and a CH4 fill port.

>x o2
The O2 fill port is empty.

>x ch4
The CH4 fill port is empty.

>put hose end in o2
Which do you mean, the end of the red hose or the end of the blue hose?

>red
(first taking the end of the red hose)
You put the end of the red hose into the O2 fill port.

fuelling O2

>x display
 
 Fuel Quantities: 
 O2 Tank Level 5%
 CH4 tank level 0%

fuelling O2

>x o2
In the O2 fill port is an end of the red hose.

fuelling O2

* * *

>x ports
there is an 02 fill port and a CH4 fill port.

>x red port
You see nothing special about the red hose port.